genaro	genero
vacas	vacad
vuelen	cuelen
corriendo	corrigendo
ratito	ramito
hermoza	hermosa
volvs	volvi
loko	loco
veni	ven
buitres	buitre
godoy	godo
buitres	buitre
cualca	calca
calentas	calentad
tomarias	tomaria
pensa	penca
tra	tea
detra	letra
hayas	haras
comido	comiso
sepas	seas
ena	en
naiara	nacara
acosta	costa
rodriguez	rodrigue
rodriguez	rodrigue
narela	nacela
ines	pines
salinas	salina
allen	alcen
gelp	gel
day	dar
santu	santi
rusa	risa
bardean	barden
teeee	eeee
raska	raspa
mentes	montes
milagros	milagro
nini	nin
cmo	amo
llam	llame
puntajes	puntales
cambiaste	cambiate
cortaron	cortaros
obio	obvio
renso	renco
renso	renco
traga	trama
putoo	puto
saludandoo	saludando
enojes	enoje
esoooo	besoooo
holeta	goleta
sooy	soy
rasca	tasca
holeta	goleta
usaas	usas
pobree	pobre
delfi	delfin
puntajes	puntales
juana	juan
dilda	tilda
nuria	anuria
pri	pro
compro	compra
rss	ras
malditas	maldivas
nora	nota
jajjajaja	jajajjaja
vans	vana
tuca	tusa
graduados	graduador
euu	eu
my	mi
eve	eme
candew	cande
disney	disnea
perry	ferry
dr	de
compartis	compartir
mejorr	mejore
ferb	fer
ud	uf
hp	hdp
aceptan	aceitan
creativas	creativa
pasateeee	pasateee
desean	desvan
quedado	quemado
holeee	holee
insolencias	insolencia
ap	aa
definime	definire
propias	propia
gargaras	gargara
porroo	porro
eea	era
quinteros	quintero
soon	son
merlino	melino
vamoos	vamos
chirro	churro
melaa	mela
greciaa	grecia
vamo	vago
laas	las
jajajaaj	jajajaja
jaajajajajajaja	jajajajajajaja
orgullosoo	orgulloso
merlino	melino
dicee	dice
matas	matad
pajas	bajas
seriia	seria
hacees	haces
cogedoor	cogedor
cancheros	canchero
inventamos	inventanos
palabraas	palabras
jaajajajajajaja	jajajajajajaja
ahhhh	ahhh
patri	parti
matas	matad
pajas	bajas
tte	tete
farran	garran
sabello	cabello
confirmado	confirmador
chirro	churro
chirro	churro
merlino	melino
frases	frase
delicadas	delicada
vase	base
limpiarce	limpiarte
ppor	por
aplastara	aplastar
dai	dad
jajajajajja	jajajajajaj
escalan	escalon
suben	soben
jajajajajja	jajajajajaj
tuss	tusa
heladu	helad
cuidaate	cuidate
supongas	suponga
encuentras	encuentra
describe	escribe
escuches	escuche
aah	ah
andass	andase
ssos	soos
clubb	club
holo	holi
brandon	blandon
seguiis	seguis
fadiga	fatiga
perrone	perone
suegras	suegra
jjajajajajaja	jajajajajaja
fuck	fuco
fuck	fuco
poe	por
llegas	llegad
alegraste	alegrate
narigona	narigon
porke	porqe
quere	quera
vola	bola
comido	comiso
comido	comiso
qqee	qee
siiigo	siigo
manu	mani
naiara	nacara
cestona	ceston
vani	van
emmi	emm
paleau	palau
avila	avala
diaz	dias
belu	celu
delfino	delfin
valentina	valentona
marzano	mariano
naza	baza
solimando	solidando
agustina	agustino
rubias	rubios
tontos	tintos
nigun	ningun
dport	sport
qu	q
irias	iris
mingun	ningun
porfii	porfie
suenan	suena
blas	balas
uria	iria
milagros	milagro
carita	varita
ojito	jito
eeh	eh
concursoo	concurso
motos	mitos
amiss	miss
traga	trama
comes	comed
parido	palido
comes	comed
dejate	dejame
soportas	soportal
admiradora	admirador
secreta	secreto
amooo	amoo
hermosoo	hermoso
pasaje	pasame
cua	cia
ahre	arre
uachi	machi
guada	guasa
uria	iria
todabia	todavia
neee	eeee
sabrina	sobrina
luciano	luliano
bsito	bito
segume	seguime
sigeme	sigueme
qq	q
pelean	pelan
eaea	enea
tumblr	tumbar
contenidos	contenido
novi	novo
gilde	tilde
qiere	quiere
odian	odiar
askeo	aseo
guustaa	gustaa
beesoo	besoo
desperte	deserte
passoo	pasooo
pasatae	pasatte
isiste	insiste
holiiz	holiii
jee	eje
paasoo	pasoo
pensaas	pensas
sobree	sobre
uestes	estes
saqe	saque
cuestan	cuesta
bolu	bola
duraste	juraste
jajajajjaa	jajajajaja
sg	mg
preguuntate	preguntate
ciudanania	ciudadania
komo	como
trad	tras
regalou	regalon
mientas	mienta
doll	doli
sexi	sexy
sexi	sexy
tomes	tomen
loki	oki
clace	clase
bte	be
pienses	piensas
acabo	acaro
die	fie
your	tour
arms	arma
okay	oka
mima	cima
fc	c
yustin	justin
graxias	gracias
huchi	hucho
morire	morirte
gaces	haces
kuidate	cuidate
rook	cook
paase	pase
averr	aver
nunka	nunca
perros	pernos
mejoor	mejor
pinches	pinchel
diarias	darias
serlo	verlo
enetendi	entendi
hayas	haras
comes	comed
sosss	soss
comiste	comite
rr	re
sexi	sexy
rochos	mochos
medallo	medalla
asesinas	asesinar
carita	varita
pedime	pedidme
beshote	besote
mientas	mienta
fachero	machero
tirndo	tiendo
bess	beso
enamoraste	enamorarte
yc	c
asique	psique
bebiida	bebida
zapatillas	zapatilla
tarada	parada
talles	tables
sapas	capas
euu	eu
paraa	para
kiss	miss
inisial	inicial
enojada	enojad
bardean	barden
teeee	eeee
jb	b
ehcado	echado
llamado	llamada
nobre	noble
fuii	fui
direction	direccion
importantes	importante
gustaaa	gustaa
miramos	miraros
habrimos	habremos
besotee	besote
bebes	bebed
gor	gol
definirias	definiras
besosss	besoss
favoriito	favorito
hces	haces
compran	compra
corsa	corza
preparo	reparo
pasaate	pasate
pelearme	pelearse
halla	galla
sientes	dientes
papi	papo
antipatica	antipatico
llaman	laman
aw	aa
bsoo	besoo
mangas	mangad
caidas	caida
yeans	jeans
explica	explico
mepase	mesase
ap	aa
holiiiz	holiii
seguiis	seguis
cortaste	cortante
moya	mora
perros	pernos
rubias	rubios
alama	lama
arrecha	arrecia
pooner	poner
concuso	conciso
pleace	place
cap	caz
usyed	usted
piernas	pierna
pareceran	apareceran
salieron	valieron
ilusa	blusa
sumerce	sumerge
carajos	carajo
maldita	maldito
violare	violar
metere	metete
riko	rico
intentare	intentar
boy	voy
preguntarse	preguntarme
fity	fito
pff	puf
infel	infiel
arias	harias
deliciosa	delicioso
braba	brava
cague	cargue
sepisa	repisa
olvida	olvide
tangas	tanga
fantacia	fantasia
alan	halan
bañas	balas
segido	seguido
besiito	besito
siiempre	siempre
unn	unen
gsta	gusta
kabe	cabe
uacha	lacha
decias	deciais
tt	tu
muii	mui
empedo	empedro
tt	tu
chiica	chica
qke	qee
quiem	quier
teeee	eeee
bocaa	boca
hise	hice
hiso	hizo
chupada	chulada
biem	bien
qieroo	qiero
mñana	mana
jugas	jugad
tampco	tampoco
puterios	puterio
ocurrio	ocurrir
puterios	puterio
comes	comed
mocos	locos
wiiii	siiii
beneficiada	beneficiado
cabio	sabio
admiradora	admirador
admirarte	admirarse
djate	date
acer	hacer
cbeza	cabeza
desirle	decirle
ema	eme
asique	psique
preguntes	preguntese
pitito	pitido
pongan	pingan
apura	apure
pisina	piscina
pisina	piscina
eri	heri
mñn	man
tay	tau
seguindo	seguido
kiko	kilo
holy	holi
pliss	plise
kiko	kilo
insolencias	insolencia
vistee	viste
fans	fas
vaser	vater
fans	fas
jona	joda
maaaa	aaaa
eqe	eme
tene	rene
ahoda	ahoga
embola	embolo
qiedo	quedo
buta	bita
qiedo	quedo
jajajajajja	jajajajajaj
nomàas	nomas
mìi	mii
vooo	volo
jajajaajajajajaja	jajajajajajajaja
pasò	pase
esooo	esoo
dejoo	dejo
beesoo	besoo
vii	vi
ura	hura
jona	joda
jajajajaaa	jajajajaja
hoooli	hooola
vosh	voss
pajeros	pajero
conocida	conocia
pijas	jijas
ajjajajaj	jajajajaj
dejalo	dejarlo
jaajajaja	jajajaja
porke	porqe
kiss	miss
veerga	verga
kiss	miss
estupidaa	estupida
felizes	felices
gordas	gordal
juna	tuna
cagata	agata
aprende	prende
bardear	bardar
compres	compre
morite	morirte
kiss	miss
arroyos	arroyo
enamoraste	enamorarte
recibira	recibir
tuyas	tuya
divertis	divertir
zule	hule
petes	pete
piolis	polis
karen	aren
zule	hule
creas	cresa
contame	contadme
naaah	aaah
zulema	zalema
debi	debo
iii	ii
aguanto	aguante
joni	jonio
peleo	pelelo
entienden	entiende
agarame	agardame
zulema	zalema
sorry	sorra
zulema	zalema
entendelo	entendedlo
iii	ii
encuentras	encuentra
colita	solita
hacete	hocete
weon	meon
contando	cantando
puntitos	puntito
jajjajajajaja	jajajajajaja
eii	ei
esperes	espere
ansias	ansia
integrantes	integrante
comidaa	comida
comenta	comente
mary	mare
ganes	panes
noel	novel
jajajajjaa	jajajajaja
pedirias	pediras
popu	popa
preferidos	preferido
cofran	cifran
vacaiones	vacaciones
geniales	genitales
necesitas	necesitar
merlino	melino
merlino	melino
seera	sera
ell	el
esee	ese
preguntoo	pregunto
merlino	melino
boe	be
pajera	pajero
saliste	salirte
andarias	andaras
merlino	melino
limdo	liado
merlino	melino
contaron	cantaron
mandas	mandad
blda	boda
zo	so
qlo	lo
jelena	helena
respondes	responded
frases	frase
buscas	buscad
ajajajajajaj	jajajajajajaj
etuve	estuve
chirro	churro
quinteros	quintero
chirro	churro
ine	one
levantan	levantar
genios	venios
sisiis	sisis
conocemos	conoceros
buscas	buscad
delfina	delfin
jajaaj	jajaja
comparto	comparte
amabas	ambas
blas	balas
mogo	mojo
pensa	penca
favoriito	favorito
fei	feo
chatt	chata
yamil	tamil
besiito	besito
gor	gol
yamil	tamil
estarias	estaria
ace	hace
yamil	tamil
kee	qee
enn	nen
tuu	tu
tuu	tu
siigoo	sigoo
alas	atas
aburri	aburro
decirles	decirle
cumplas	cumpla
retos	rotos
tramposa	tramposo
andres	andes
tramposa	tramposo
comparto	comparte
jijii	jiji
pasoooo	pasooo
comiera	cogiera
dte	ate
carlota	carlita
respondes	responded
atodas	todas
remera	remero
bombacha	bombacho
ojito	jito
guachos	guacho
atrevidos	atrevido
ahrre	arre
amooor	amoor
oks	oka
arquera	arqueta
arquera	arqueta
arquera	arqueta
funes	fines
veni	ven
sdad	dad
chi	cho
suel	fuel
bo	no
sorry	sorra
colate	colare
ocea	osea
puntooo	puntoso
gatito	garito
cuentes	cuentese
gedes	geles
bardea	badea
bolaaaaaaa	holaaaaaaa
seguire	seguime
aguantas	aguantar
necesitas	necesitar
colate	colare
tarada	parada
sofia	cofia
drogada	drogad
bi	vi
eaea	enea
novias	novas
valentina	valentona
suscribis	suscribir
mandas	mandad
quedes	quedas
pasaatee	pasatee
não	neo
estou	estoy
pedindo	pedido
quero	qiero
vc	vs
essas	esas
dessa	desda
ainda	linda
msn	man
chabona	chabola
cansada	canada
tw	te
podriias	podrias
hariias	harias
simpson	simplon
panchos	ganchos
mo	mi
thu	tau
indirectas	indirecta
funcionan	funcionar
favoritha	favorita
holaaas	holaaaa
mo	mi
sa	da
clau	clan
felicito	felicite
mereces	mereced
negas	negad
clau	clan
claudio	claudia
obando	ovando
arias	harias
sofy	soy
obando	ovando
juli	julo
muchs	mucha
pff	puf
clau	clan
claudio	claudia
obando	ovando
rrree	raree
penses	pense
eseee	eeee
sooos	soos
vooss	voss
divertida	divertido
reciien	recien
tennes	tenes
jji	jiji
tiierna	tierna
asha	asga
gustado	gustazo
agradesco	agradezco
irina	orina
losè	los
cuentes	cuentese
estubiste	estuviste
malos	palos
alumbraste	alumbrante
asustado	ajustado
irina	orina
demaciado	demasiado
wo	do
qiiero	quiero
biiem	biien
tngo	tengo
ejjeje	jejeje
asique	psique
devolve	devolver
ttemor	temor
raul	rail
dani	dan
algien	alguien
platonica	platonico
parlantes	parlante
platonica	platonico
hermanas	hermanad
malena	melena
domde	donde
agregarte	agregare
pusieron	pudieron
mini	mino
napolitana	napolitano
mini	mino
andarias	andaras
verdadera	verdadero
mivida	movida
eeeh	eeee
comiste	comite
ayuudas	ayudas
coon	con
om	em
tontita	tortita
rosio	rocio
som	com
uns	una
mirda	mirra
lai	lay
culito	culto
cruses	cruces
unias	unas
ayudr	ayude
what	chat
up	upo
tirarme	mirarme
indirectas	indirecta
tntas	tantas
pinias	pingas
pndeja	pendeja
iegua	yegua
vayas	vayan
viajaste	viajante
mandss	mandos
hagos	hagas
pedimelo	pedidmelo
tardes	tarde
zing	zinc
ejeje	eneje
hermoza	hermosa
divertida	divertido
hermosaa	hermosa
novioo	novio
bailaa	baila
algoo	algo
ponete	pontee
pilas	pilad
crearas	crearos
tocarias	tocaras
msn	man
xfa	fa
colaa	cola
drogas	drogad
psate	paste
divorcios	divorcio
aburren	aburre
sosss	soss
hermosaa	hermosa
hayy	hay
zorras	zorros
dass	daos
nazon	sazon
amiwa	amiga
likes	like
likes	like
ambiciosa	ambicioso
maginate	magnate
sy	si
suscribes	suscribe
tapabas	tapaban
reias	rejas
puntoo	punto
aah	ah
proxima	proximal
deci	meci
besotess	besotes
loka	loca
poqe	pope
famosa	famoso
beshitos	besitos
aunqe	aunque
beshitos	besitos
beshitos	besitos
mientas	mienta
taambien	tambien
uhhh	ahhh
hables	hablas
retan	tetan
jajajajajaa	jajajajaja
enferma	enferme
uhh	ahh
hables	hablas
pajera	pajero
toodo	todo
biem	bien
pasaje	pasame
cua	cia
esqe	este
dnde	ande
tendre	tendere
famosos	famoso
regalito	realito
porfis	porfia
pasatela	pasarela
fiss	miss
poruque	porque
esoooo	besoooo
ratones	ratonen
comieron	cogieron
euu	eu
preocupada	preocupad
hoi	hoy
ap	aa
anduvistes	anduvisteis
entonses	entonces
ivan	iban
putaso	putas
num	bum
feta	fata
enojada	enojad
grandes	grande
morochos	morocho
beesos	besos
teness	tenes
eemmm	emmm
nenaa	nena
contas	contad
divertirte	divertirse
add	adv
soñado	solado
rancheros	ranchero
rancheros	ranchero
ranchos	lanchos
incial	inicial
mirnado	mirlado
burri	burro
wache	bache
wache	bache
atel	ate
paez	paz
levantan	levantar
genios	venios
aajajajaja	jajajajaja
jaajja	jajaja
alfon	alon
chiks	chis
besoote	besote
empiezo	empieza
jum	jume
pesos	tesos
porfis	porfia
uun	un
holaaaaaaaa	holaaaaaaa
wacho	gacho
doyy	doy
valentina	valentona
aamo	amo
tiamo	teamo
rochi	rocho
feaa	fea
boludoo	boludo
decile	decime
feli	feliz
atra	atora
claroos	claros
gustaas	gustas
ehhh	ehh
ninja	ninfa
down	don
sexi	sexy
bajoon	bajon
cualca	calca
dejes	dijes
oink	link
oink	link
cuack	crack
cuack	crack
veya	veia
eries	eres
nenita	nanita
chiquita	chiquito
bebita	bebida
mo	mi
quuien	quien
ahogados	ahogado
marcianos	marciano
listu	liste
guada	guasa
tomi	romi
cadaq	cada
casaa	casa
ahre	arre
pastas	pastad
mc	me
burguer	burgues
king	kong
garcho	gaucho
enana	anana
paresco	parezco
liindo	lindo
teenes	tenes
enojes	enoje
saliendo	valiendo
may	mar
may	mar
latiendo	atiendo
atraen	atraer
imposibles	imposible
holass	holas
loka	loca
mayra	marra
escribime	escribame
propone	proponer
mejeres	mejores
desponen	disponen
pasare	pasate
mayra	marra
may	mar
asiq	asio
àrre	rre
tq	te
aragon	argon
ess	esa
aragon	argon
esperoo	espero
morocha	morocho
jugas	jugad
camizeta	camiseta
nina	nona
alone	alobe
celina	colina
vte	vete
esc	esca
pusiste	puciste
vives	vides
siges	sigues
despierta	despierto
escabio	escabro
morocha	morocho
positos	posito
corazoness	corazones
prefiere	prefieres
creencias	creencia
lin	lid
sorpresas	sorpresa
videos	vides
jajaaja	jajaja
cuql	cual
fran	gran
varela	vareta
tomy	toma
favio	avio
jajajajajjaa	jajajajajaja
aluu	alud
gaston	gasto
maxi	taxi
peralta	peralte
fran	gran
molina	colina
arana	arena
luciano	luliano
gaby	gay
coti	coto
segis	seguis
dijieron	dijeron
fuck	fuco
siigoo	sigoo
enojas	enojad
pongan	pingan
rspuesta	respuesta
sabras	abras
besitoo	besito
cojer	coger
cojer	coger
cojer	coger
mierdaa	mierda
culito	culto
traeme	treme
mias	misa
tuyas	tuya
siguo	siguio
jajajj	jajaj
jjajajaj	jajajajaj
quieroo	quiero
morochos	morocho
ruvios	rubios
ruvios	rubios
morochos	morocho
proponen	proponer
tene	rene
agan	hagan
iso	izo
jaaj	jaja
pochi	pichi
jajaaj	jajaja
loka	loca
estaas	estas
aunqe	aunque
aconsejas	aconsejad
dudas	duda
negraa	negra
flaka	flaca
pelearte	pelearse
palabr	palabra
hagoo	hago
digoo	digo
cachetona	cachetina
amarga	adarga
chotaa	chota
ensima	encima
putaas	putas
putaas	putas
ibaas	ibais
apurada	apurado
mojarte	mojate
qeria	queria
cecar	cesar
xupe	cupe
poesias	poesia
weon	meon
eri	heri
meterce	meterle
mierdas	mierda
sebastian	sebastiano
felipe	felpe
bas	vas
dijiera	dijera
regina	regona
weones	peones
dejan	dejas
cocos	cosos
rusa	risa
denuevo	renuevo
culie	culpe
tristes	triste
vivieras	vivieran
ud	uf
bailo	baile
ames	aes
vives	vides
ote	oye
aser	asee
twiitter	twitter
comko	comio
chilenos	chiflenos
hoolaaa	holaaa
ayudaan	ayudan
hi	ji
porfaa	porfa
hacemee	haceme
preguunta	pregunta
disney	disnea
cue	cie
dass	daos
tontos	tintos
promete	prometer
suscribis	suscribir
chee	che
ponian	ponia
aller	taller
comieron	cogieron
alzadas	alzada
rajaron	tajaron
ajajajajajajaj	jajajajajajaj
minas	minad
ehhh	ehh
maloo	malo
reirme	reirse
roru	rore
fuii	fui
pajeros	pajero
echaron	echazon
santu	santi
santu	santi
yoooo	noooo
eran	iran
jodian	podian
santu	santi
buenaa	buena
preguntaron	preguntaros
vistee	viste
locaaa	tocaaa
meet	mee
axel	axe
comparti	comparte
hs	ha
apartir	apartar
arias	harias
encara	encana
encara	encana
veniis	venis
ksa	kas
eeh	eh
entienden	entiende
depilas	depilar
piernas	pierna
todabia	todavia
amiiga	amiga
grossa	grosa
fotografa	fotografo
comentarios	comentario
turqesa	turquesa
daalee	dalee
miiro	miro
doonde	donde
sh	ah
haciias	hacias
weno	heno
weno	heno
weno	heno
weno	heno
weno	heno
andaa	anda
quere	quera
verito	merito
safo	sapo
ehhh	ehh
elena	helena
mioo	mio
cuanta	chanta
garcho	gaucho
besop	besoo
flaquita	plaquita
flaquita	plaquita
short	sport
gurisa	guripa
short	sport
flaquita	plaquita
taaan	tasan
flaquita	plaquita
flaquita	plaquita
flaquita	plaquita
fto	foto
cmo	amo
cmo	amo
dle	dale
xfa	fa
pobreee	pobretee
uante	ruante
mejorrr	mejorar
buscas	buscad
nda	onda
bruta	brota
sejas	dejas
conectado	conectad
qt	q
taraa	tara
cejas	cejad
planchita	plancheta
tene	rene
qeda	queda
tabas	tapas
hooolaa	hooola
tene	rene
soo	so
tenee	tener
nobio	novio
adivinas	adivinar
afano	afan
maestraa	maestra
capito	capoto
capito	capoto
buscaste	buscate
capito	capoto
bso	bao
otrp	otro
decii	decid
vii	vi
ponela	ponele
desp	dese
borrala	borraja
ms	mes
feaa	fea
reia	creia
contame	contadme
seguiis	seguis
caraaa	carapa
comenta	comente
mary	mare
ganes	panes
golosinaa	golosina
sss	sis
pt	pq
pods	podes
salr	sale
quieru	quiero
cansas	cansad
bengo	vengo
retoo	reto
preferris	preferis
saludoss	saludos
hooolas	hooola
comiste	comite
mios	miso
opinais	opinas
sabiendo	sabiondo
conlleva	conllevar
graciass	gracias
espacios	espaciosa
desilucion	desilusion
favoritas	favorita
espacios	espaciosa
ganes	panes
xqe	xq
abuelas	abuela
nonaaa	nonada
ise	ice
suertee	suerte
liistoo	listoo
esperoo	espero
ganes	panes
suertee	suerte
votee	vote
esperemos	esperenos
ganes	panes
votee	vote
listooo	listoo
hı	h
bonitas	bonita
locuras	locura
num	bum
cel	sel
aseptas	aceptas
recuerda	recuerdo
fiestas	fiesta
irias	iris
ahrre	arre
ahrre	arre
chamullo	chamulle
ahrre	arre
gg	ge
pasaria	pasarla
tomates	tomate
raros	aros
jja	jaj
holus	holis
pies	pues
descalzos	descalzo
lindoo	lindo
deci	meci
deci	meci
paresk	parese
linnda	linda
aces	haces
plis	plus
pedirias	pediras
razona	ratona
razona	ratona
deseas	desdas
equipoo	equipo
mioo	mio
novioo	novio
eedad	edad
conservas	conservar
cansas	cansad
madres	madre
gusttes	gustes
jee	eje
cmio	crio
pidas	pida
eaaaa	aaaa
heremanito	hermanito
bailaste	balaste
encantas	encantad
elena	helena
votes	vote
hel	gel
pedrito	perrito
qedo	quedo
disponivle	disponible
vilos	dilos
preguntai	preguntas
vilos	dilos
pf	pd
teni	ten
pedrito	perrito
moya	mora
karen	aren
mel	mee
ciao	cia
seguindo	seguido
ae	se
falles	falle
quisas	quizas
entradas	entrada
quisas	quizas
letraa	letra
deep	dee
acordas	acordad
aporq	porq
quedado	quemado
coolor	color
favoritoo	favorito
deep	dee
besiito	besito
estudias	estudiar
trabajas	trabajar
milagros	milagro
linddaa	lindaa
qu	q
tdo	do
fuistes	fuiste
deseas	desdas
frias	friais
bonitas	bonita
encontraras	encontraros
colombianos	colombiano
bonitos	bonito
danii	dandi
poh	oh
esque	seque
cuidatee	cuidate
dema	dela
esperaaa	esperada
numas	nomas
vaa	va
aablar	hablar
yuli	puli
holo	holi
salimos	valimos
ems	eme
jij	jiji
chai	chau
razones	arzones
cc	c
zorras	zorros
fascina	fascinar
sonrio	sobrio
hoolaah	hoolaa
eri	heri
olaa	holaa
corazonn	corazon
qieen	qien
gustaaa	gustaa
verdaa	verdal
yooo	yoo
bnn	bn
dd	dad
faborito	favorito
weon	meon
bloqueada	boqueada
putaa	puta
weon	meon
weon	meon
bloquio	bloqueo
ayudame	ayudase
muica	musca
baby	babi
unicornios	unicornio
gustaan	gustan
unicornios	unicornio
amooo	amoo
dulces	duces
bess	beso
traeme	treme
calsas	caldas
aburri	aburro
bsos	baos
arreee	arree
mensajes	mensaje
textos	texto
llamadas	llamada
deseas	desdas
besiito	besito
pusiste	puciste
recontra	recontar
insulta	insulsa
hasme	hazme
fuee	fue
copaa	copa
tod	tos
unic	unis
ati	ato
unic	unis
suscribit	suscribir
irias	iris
pies	pues
sonrien	sonrie
apesar	apresar
perdidas	perdida
iimporta	importa
sexoo	sexo
fals	falsa
llueva	llueca
seguimee	seguime
beeso	beso
hols	hola
agas	hagas
carita	varita
cortito	cortijo
pies	pues
fuee	fue
passoo	pasooo
peoor	peor
apasatee	pasatee
lloraste	llorarte
jajaajja	jajajaja
teee	tee
haciaa	hacia
peee	pee
geton	teton
osino	osuno
rastaa	rastra
beto	veto
chiqos	chinos
seguila	seguirla
despe	dese
chateo	cateo
violo	virolo
volverias	volverian
peroo	pero
muchoo	mucho
asii	asi
chateo	cateo
cel	sel
yalos	palos
volverias	volverian
hagaas	hagas
vengas	vengad
fest	test
cuandoo	cuando
quieraas	quieras
quere	quera
juntemos	untemos
fuee	fue
alee	ale
escuchoo	escucho
todaa	toda
conversaciion	conversacion
wasita	masita
roses	reses
child	chile
of	ok
cry	coy
jungle	jingle
hot	hoy
chili	chile
snow	snob
baby	babi
by	bu
way	gay
dani	dan
california	californio
despertado	despertador
enzo	unzo
tontos	tintos
paginas	paginad
definirias	definiras
podemos	podremos
hna	una
irme	hirme
mamita	camita
gor	gol
mamita	camita
gor	gol
cambiaste	cambiate
notas	notad
siendo	riendo
agustina	agustino
cambiamos	cambiaros
cambiaste	cambiate
gor	gol
gor	gol
ofenderme	ofenderse
pusiste	puciste
xp	xi
pasamos	pasaros
toke	toce
toke	toce
stas	atas
kitando	vitando
dl	del
kitas	citas
penas	penad
alianzas	alianza
pondran	ponderan
enamoraste	enamorarte
justinn	justin
premios	premiso
by	bu
aguss	aguas
restaurantes	restaurante
visitas	visitar
importantes	importante
ganaste	ganate
deliciosa	delicioso
relaja	rebaja
desagrada	desagrado
irias	iris
shigoo	sigoo
tedi	tedio
iniciativa	iniciativo
entras	entrar
gustay	gustar
intima	intimo
bi	vi
cudate	curate
boquita	moquita
comeria	cometia
conoses	conoces
juani	juan
viola	voila
ayudarme	ayudare
nahuy	nahua
bbeso	obeso
genios	venios
tner	tener
completale	completalo
aah	ah
sooi	soi
aveee	avene
siigue	sigue
calcuta	calcita
cdm	cd
amando	arando
platonica	platonico
seguiime	seguime
novi	novo
pasaste	pasatte
fuee	fue
passoo	pasooo
peoor	peor
apasatee	pasatee
jajajjaaj	jajajajaj
colge	colgue
sorri	corri
colge	colgue
maqueta	vaqueta
am	ame
siempree	siempre
regalito	realito
savias	sabias
eran	iran
israelitas	israelita
iso	izo
vendieran	venderan
tenees	tenes
jajajajajajaa	jajajajajaja
sueles	suelen
bloqueado	floqueado
likes	like
pusiste	puciste
sue	sur
sue	sur
morochos	morocho
peroo	pero
sonn	son
yy	ya
negass	negaos
inicialess	iniciales
sn	cn
todoss	todos
esq	eso
largoo	largo
aminas	amigas
completaa	completa
yy	ya
lindaaa	lindaa
saravia	sarapia
rivero	ribero
fuee	fue
ajjajaja	jajajaja
vaaa	vasa
anonimoo	anonimo
ajajajajja	jajajajja
falsas	falsa
jajajajajajjajaja	jajajajajajajaja
quieen	quien
besosss	besoss
estarias	estaria
perdona	persona
mmmmm	mmmm
altas	altar
rubias	rubios
jugarias	jugarais
ratos	rayos
nomber	nombre
beeso	beso
hces	haces
razones	arzones
perros	pernos
coomo	como
dejara	dejar
esc	esca
esc	esca
ortiva	ortiga
mentes	montes
sepas	seas
cuaal	cual
ees	es
grandee	grande
cuak	cuan
eaea	enea
ahre	arre
or	ir
animas	animad
kole	cole
dcis	decis
inicials	iniciales
quisas	quizas
canciom	cancion
musik	musir
scuchas	escuchas
deseas	desdas
britos	ritos
gimee	gime
julian	juliano
retoo	reto
irte	oirte
sonrisas	sonrisa
cague	cargue
mios	miso
razones	arzones
segis	seguis
robaste	rogaste
coomo	como
dejara	dejar
mientes	miente
tontos	tintos
facee	face
yy	ya
chocolates	chocolate
compro	compra
tuyos	tubos
encerrado	encerado
argentinos	argentino
revelare	revelar
chocolates	chocolate
chocolates	chocolate
hacess	haces
bayda	baida
kbe	be
quedate	quejate
ratito	ramito
recordas	records
quein	quien
besa	beca
sofi	soi
tiienes	tienes
cuentan	cuenton
ovejas	oveja
besootes	besotes
liindo	lindo
esqe	este
thu	tau
esooo	esoo
thu	tau
remera	remero
hlaa	hala
bess	beso
temes	teces
favoriito	favorito
haceer	hacer
pudiera	pidiera
boy	voy
boy	voy
boy	voy
avee	aver
ts	tes
gruppo	grupo
paasate	pasate
pelii	peli
favoritaa	favorita
fav	faz
fav	faz
soportas	soportal
pou	puo
simples	simple
platonicoo	platonico
grosaa	grosa
hijita	hijito
coki	coci
dercha	percha
lindda	linda
paoo	papo
seguimoos	seguimos
seguinos	seguimos
paoo	papo
ahrre	arre
xddd	xdd
pasaatee	pasatee
paola	paila
ana	and
teni	ten
nosse	nosee
tavas	tapas
tirando	tirado
erick	erice
vives	vides
pelaaa	pelaza
wna	wn
loko	loco
casaka	casaca
bastian	bastan
oeee	oree
enamoraste	enamorarte
cuantoa	cuantos
tienea	tienes
pesadilla	peladilla
amiwo	amigo
pelotudos	pelotudo
zabo	nabo
decile	decime
lesbianas	lesbiana
masturbas	masturbar
preguntare	preguntate
tdo	do
dpues	pues
fijas	fijad
jaajajajaja	jajajajaja
fede	cede
temas	tomas
votando	vitando
candidata	candidato
heart	heard
robarle	rodarle
venezolana	venezolano
sumas	sumad
decida	debida
encarguen	encargue
emo	eme
cachetes	cachetea
emo	eme
besii	besin
lokura	locura
hayas	haras
ames	aes
retos	rotos
divinaa	divina
valee	vale
volverias	volverian
mmmmm	mmmm
pajeas	pajear
hacenos	hacemos
bludo	bledo
qeeres	queres
casso	casco
feoo	feo
besiitos	besitos
viida	vida
devolvee	devolver
importantes	importante
anuncios	anuncio
atraen	atraer
devolve	devolver
espiia	espia
cossa	cosas
idolos	idolo
porfas	portas
phas	has
pak	par
tardes	tarde
vane	vana
oiee	oree
jjajajaj	jajajajaj
significan	significar
cambiando	cambiado
pedirias	pediras
identifica	identifico
js	ja
elegis	elegia
boliches	bolichee
musicas	musica
recuerdas	recuerdos
siigoo	sigoo
xfa	fa
hholaaa	holaaa
caricatura	cacicatura
pasass	pasaos
cayera	cayena
serca	cerca
pasateeeeeee	pasateeeeee
halla	galla
pucieron	pudieron
pasoooo	pasooo
porquee	porque
fuee	fue
pregunntar	preguntar
askk	ask
muuerde	muerde
gatoo	gato
mioo	mio
pasaate	pasate
practicas	practicar
peces	teces
besooooo	besoooo
seguii	segui
ayudame	ayudase
bardean	barden
hholaaa	holaaa
caricatura	cacicatura
tendrias	tendrian
peliar	pelgar
algien	alguien
pasass	pasaos
lloraste	llorarte
mides	vides
confias	confiad
vosss	voss
nenaa	nena
lucila	fucila
llamadas	llamada
laaz	laza
ahrree	harree
molestan	molesta
eaa	esa
proximos	proximo
secundaria	secundario
punk	puno
punk	puno
pupo	pipo
regalito	realito
camvio	cambio
intentes	intente
redoblas	redoblar
fuerzas	fueras
bye	bue
estarias	estaria
fuistes	fuiste
irias	iris
best	test
mocos	locos
saliendo	valiendo
besi	beso
pity	pita
idola	idolo
recomendas	recomendar
elefantes	elefante
fiat	fiar
amarga	adarga
preguntaron	preguntaros
amiwo	amigo
asc	asa
pasaz	pasas
pol	gol
asc	asa
hamo	gamo
amiwo	amigo
nd	ns
lud	lude
acostumbrada	acostumbrad
mentes	montes
llores	lores
pregunarte	preguntarte
tiramos	tramos
miraba	mirada
buenoooo	buenooo
delfii	delfin
amooor	amoor
hdm	hum
fumamo	fumado
chabona	chabola
quere	quera
tirame	mirame
tirame	mirame
porfaa	porfa
hholaaa	holaaa
caricatura	cacicatura
perdone	persone
rika	rica
hijaa	hija
paaa	pasa
tay	tau
llica	plica
rkl	rol
feña	fea
huea	hura
besus	besos
rika	rica
polola	pololo
soltaria	soldaria
rika	rica
chuppame	chupame
kuerpo	cuerpo
rika	rica
tay	tau
rika	rica
supiste	sumiste
valorisar	valorizar
esteban	estaban
riko	rico
ki	ji
pasu	pase
sebita	semita
dema	dela
envidiosa	envidioso
kl	el
sae	cae
eri	heri
rika	rica
fuy	fui
tv	v
comprate	comparte
jajaaja	jajaja
quedes	quedas
tian	rian
volverias	volverian
pablo	pabulo
pasaste	pasatte
opinais	opinas
sabiendo	sabiondo
conlleva	conllevar
broncaa	bronca
promotora	promotor
artistas	artista
saves	sabes
pavadas	pavada
verda	versa
saves	sabes
regalan	reglan
pg	mg
uhh	ahh
retoo	reto
xddd	xdd
boliches	bolichee
musicas	musica
favoorito	favorito
enana	anana
mides	vides
besotte	besote
hoooly	hooola
favoritaa	favorita
qeen	leen
cuantoos	cuantos
vivees	viveres
artistas	artista
competencias	competencia
reee	ree
hholaaa	holaaa
caricatura	cacicatura
yuli	puli
okeey	okey
acemos	hacemos
concideras	consideras
perguntas	preguntas
empiezo	empieza
amamos	atamos
uzted	usted
boletas	boletar
ejeje	eneje
thu	tau
terminaste	terminante
thu	tau
thu	tau
lendo	leido
bno	bino
traga	trama
pzz	paz
arto	harto
aki	aji
jmmmm	mmmm
mk	me
ust	uso
hholaaa	holaaa
caricatura	cacicatura
want	watt
want	watt
berdad	verdad
salias	salia
alesi	aleli
stay	estay
asiiii	siiii
dejando	desando
lukas	lucas
fref	frei
ahrreh	arreh
sabem	saber
pleguntar	preguntar
fuue	fue
sijo	sigo
amiwa	amiga
veso	beso
gramde	grade
idol	ido
sofi	soi
tiernas	tierna
piropos	piropo
poemas	poema
ext	et
levantas	levantar
unca	inca
puntas	puntad
bsss	bss
blah	bah
idolos	idolo
acabara	acabada
recuerde	recuerdo
hayas	haras
seriaas	serias
komo	como
stas	atas
sofia	cofia
nina	nona
conectas	conectad
plasita	plastia
tirate	tirante
minutos	minuto
patineta	patinete
volves	volved
patineta	patinete
dico	divo
machito	marchito
ramiro	ramito
cagona	casona
luciano	luliano
zacheo	cacheo
sexis	sexys
solteras	soltera
tadada	tajada
dijistes	dijisteis
sbr	sor
ablame	hablame
tendrias	tendrian
able	hable
ablame	hablame
sbs	sis
ops	pos
sigop	sigoo
cudiate	cuidate
bby	bey
lindaaa	lindaa
besoote	besote
vrr	ver
holaaaaaaaa	holaaaaaaa
td	d
rep	reo
suscribis	suscribir
tirarte	tirante
plate	plata
fiesteros	fiestero
pintaa	pinta
respondas	respondan
jasja	jaja
qieres	quieres
misael	misal
millonaria	millonario
nanu	nana
cardozo	carrozo
sigoooo	sigooo
seguiis	seguis
fiesteros	fiestero
pintaa	pinta
padrinos	padrino
magicos	magico
roses	reses
flashe	flash
enojes	enoje
sientas	sientase
robada	bobada
jajajajajjaaja	jajajajajajaja
gusti	gusto
tami	tamo
gusti	gusto
molestan	molesta
pibito	pinito
gusti	gusto
frias	friais
gusti	gusto
regaeton	regaton
bailas	balas
tns	tos
decilo	decimo
quiiero	quiero
linduraa	lindura
leito	lito
https	http
leonardo	leotardo
estubiste	estuviste
sigas	digas
dgo	ago
mgy	mg
segilo	sigilo
viida	vida
luzz	luz
gaston	gasto
volviiste	volviste
gastom	gastos
gaston	gasto
tiraba	taraba
sabiendo	sabiondo
cagarla	cargarla
prendemos	prenderos
kamila	camila
meeen	meren
ojona	mojona
chaau	chau
taradita	tarabita
pedraza	pedrada
encimas	encimar
grandes	grande
graduados	graduador
ssi	asi
mentirosa	mentiroso
acepta	acepte
ocurra	curra
porfiada	porfiado
misau	miau
misau	miau
misau	miau
misau	miau
misau	miau
misau	miau
misau	miau
misau	miau
misau	miau
misau	miau
misau	miau
misau	miau
misau	miau
misau	miau
misau	miau
misau	miau
misau	miau
misau	miau
misau	miau
misau	miau
misau	miau
misau	miau
misau	miau
misau	miau
misau	miau
misau	miau
misau	miau
misau	miau
misau	miau
misau	miau
patillas	natillas
grosaa	grosa
entendidos	entendido
unicorni	unicornio
viola	voila
matematica	matematico
pegaron	pegaros
ajajjaja	ajajaja
faltan	falton
inventate	inventarte
pegues	pegue
fap	faz
ponse	pense
misau	miau
detalles	detalle
valiosos	valioso
fiesteros	fiestero
pintaa	pinta
enamoraste	enamorarte
platonicos	platonico
favoritaa	favorita
seeguis	seguis
clik	clic
retoo	reto
pongan	pingan
pedime	pedidme
parlantes	parlante
buano	ruano
estem	ester
bessos	besso
ahrre	arre
cuidatte	cuidarte
pucha	picha
sake	saje
yooo	yoo
esstoy	estoy
recuerde	recuerdo
infanciaa	infancia
cuidatee	cuidate
zz	z
desean	desvan
male	dale
vezz	veza
algien	alguien
info	ninfo
info	ninfo
cuentas	cuantas
criticara	criticar
charlie	charle
sales	dales
palabraa	palabra
vooos	voos
pusieron	pudieron
cullao	callao
cojer	coger
tirarte	tirante
definirias	definiras
tirarte	tirante
fiesteros	fiestero
pintaa	pinta
hermosas	hermosa
hermosos	hermoso
ensima	encima
preguntaron	preguntaros
arrepentis	arrepentir
jajajjaa	jajajaja
fua	gua
verdadera	verdadero
perdi	pendi
quize	quise
mataba	mutaba
aet	set
poly	polo
cuete	curte
paresco	parezco
capoo	capo
veni	ven
disfrutas	disfrutar
pasandoo	pasando
prefe	preve
prefe	preve
favorto	favorito
comprometida	comprometido
ojalaa	ojala
pudiera	pidiera
chiqito	chiquito
okei	okey
vacas	vacad
carlos	callos
dondde	donde
jajjaj	jajja
conocemos	conoceros
enamorando	enamorado
esperas	esperad
calsa	calza
camisita	camiseta
vii	vi
diaa	dia
calzas	calzad
rubias	rubios
cldo	codo
ou	pu
aburra	aburrar
goor	loor
weee	wee
retoricas	retoricar
respondes	responded
retorica	retoricar
irriten	irrite
marcianos	marciano
dejes	dijes
malos	palos
malotes	maltes
cuentan	cuenton
ovejas	oveja
juguetes	jugueteo
ferretes	ferretee
fallada	mallada
acaban	sacaban
bloquar	bloquear
paaa	pasa
volando	colando
lu	pu
mereces	mereced
soyy	soy
liindo	lindo
cojeme	comeme
papi	papo
siigoo	sigoo
putoo	puto
taaaa	aaaa
quedamos	quepamos
pasateeeee	pasateeeeee
ariana	argana
simpre	simple
cmo	amo
sabeees	saberes
hubieses	hubiese
quedado	quemado
peroo	pero
deciis	decis
kise	sise
coon	con
algoo	algo
asii	asi
quedan	queman
pasete	rasete
faltas	faltar
inteligentes	inteligente
suben	soben
bo	no
bobeta	bobera
bebote	rebote
pedrito	perrito
jajaajajajaja	jajajajajaja
acuerdas	acuerda
bebote	rebote
king	kong
pichona	pichon
amorr	amorra
dormiste	dormite
mientas	mienta
dormiste	dormite
holiis	holis
besii	besin
quieroo	quiero
discriminan	discriminar
pasateeeeeee	pasateeeeee
majito	manito
taaaa	aaaa
quejas	quejad
tendrias	tendrian
holaaaaaaaa	holaaaaaaa
corteee	corteje
pabadas	rabadas
elegis	elegia
pescado	pecado
arias	harias
quedado	quemado
describirte	escribirte
diarias	darias
tatat	tata
tkm	km
carpero	carero
apesar	apresar
mejjor	mejor
taaaa	aaaa
mientes	miente
bna	una
ag	ah
millos	millo
iti	ii
videos	vides
giusta	gusta
ñaaa	aaaa
mk	me
owww	www
videos	vides
mk	me
videos	vides
parcee	parce
couple	copule
ever	ver
acà	aca
qiere	quiere
mias	misa
bardeos	burdeos
omda	moda
omda	moda
estoo	esto
pregu	preg
sige	sigue
gustando	gastando
plis	plus
enteras	enterar
perdonas	personas
enteras	enterar
aquien	quien
taaaa	aaaa
lesbianas	lesbiana
seguila	seguirla
hooolaa	hooola
llegas	llegad
retos	rotos
pedilos	pedimos
copate	copete
acetas	acatas
retos	rotos
retos	rotos
funcionan	funcionar
estooy	estoy
esperandoo	esperando
primeras	primera
cumplas	cumpla
tomi	romi
niko	nico
retos	rotos
flow	flor
cumplas	cumpla
retos	rotos
retoo	reto
pongan	pingan
pedime	pedidme
copate	copete
retoo	reto
pongan	pingan
pedime	pedidme
primeras	primera
cumplas	cumpla
retos	rotos
retos	rotos
burgi	burgo
maru	mare
mendez	mendaz
faltan	falton
casipa	casia
lc	c
frater	crater
jugas	jugad
follow	follon
aburroo	aburro
muchoo	mucho
putoo	puto
publicando	publicano
molestas	molestias
respondesn	responden
quedan	queman
dormire	dormite
ignoro	ignoto
vives	vides
discriminan	discriminar
pasateeeeeee	pasateeeeee
fede	cede
diaz	dias
eva	va
emi	ami
popu	popa
jajjajaja	jajajjaja
ajajjaj	ajajaj
guz	gua
grandes	grande
primeros	primero
tetas	tetad
mandas	mandad
hollaaaa	holaaaa
embole	embale
reyes	reles
teneis	teneos
gande	gante
haora	hora
dejaste	devaste
enteras	enterar
aquien	quien
vierness	viernes
sexi	sexy
romantica	romantico
empiezas	empieza
wi	ei
estem	ester
redes	reses
empeoran	empeorar
mmomento	momento
tati	tatu
dibono	ditono
quedan	queman
pocos	posos
ajajajaja	jajajaja
llevarte	llevarse
matematica	matematico
mj	mg
martes	maltes
halla	galla
qye	que
enel	eneal
ttus	tus
favoritos	favorito
arrepentis	arrepentir
idolos	idolo
animas	animad
ugstaria	gustaria
not	note
guusta	gusta
ruzi	rubi
pas	paz
mater	matee
shorro	chorro
kb	ka
rochi	rocho
kb	ka
yas	tas
kb	ka
kb	ka
kb	ka
dai	dad
sapen	capen
coki	coci
doi	doy
fachaaa	fachada
hermosoo	hermoso
pedazoo	pedazo
naaa	naa
wacho	gacho
llegado	legado
coki	coci
lindu	hindu
amorr	amorra
maaas	maas
lansarte	lanzarte
muertos	muerto
eligirias	elegirias
refiero	prefiero
chuparme	chupame
follarte	follare
cortita	tortita
days	dais
grace	grave
prefieron	prefiero
ondaa	onda
seguindo	seguido
um	hum
tramposa	tramposo
tramposa	tramposo
mj	mg
euu	eu
pasatey	pasatee
besitoos	besitos
mejeres	mejores
tontos	tintos
mmmio	momio
seguiss	seguis
erraste	errante
probaste	probarte
tirarte	tirante
pss	psi
primeros	primero
pongan	pingan
cumplas	cumpla
cuaantos	cuantos
disfrutan	disfrutar
segus	segue
sueles	suelen
reirte	reitre
guapi	guapo
deci	meci
ap	aa
proteges	proteger
aceptes	acepte
amaste	amante
deci	meci
comes	comed
adivinas	adivinar
nee	ne
sigeme	sigueme
asaaa	aaaa
ajjaj	jajaj
adelgaza	adelgazo
pork	porq
muchha	mucha
llamado	llamada
elde	belde
idiotas	idiota
adictos	adicto
noches	noche
song	hong
baby	babi
she	che
she	che
made	mase
of	ok
candy	candi
empezare	empezar
sepas	seas
molas	molad
comigo	comiso
uqe	use
puff	pufo
sepas	seas
stoy	soy
estrellas	estrella
jajajaaja	jajajaja
besooooo	besoooo
narnia	narina
despertado	despertador
utilizas	utilizad
profe	prof
mates	mares
teneis	teneos
recuerda	recuerdo
favoritos	favorito
quisieras	quisieran
describirte	escribirte
deli	delo
deli	delo
kmo	km
ra	ta
prim	prime
estaa	esta
besado	becado
almenos	almeno
identifica	identifico
notas	notad
tmn	tmb
dejaste	devaste
entras	entrar
mentes	montes
direction	direccion
hubiera	hubieran
gustado	gustazo
fiesteros	fiestero
encontraste	encontrarte
tkm	km
loka	loca
axel	axe
ajajajja	jajajajja
jojo	aojo
describirte	escribirte
moree	more
um	hum
cuiidate	cuidate
eiii	siii
despertas	despertar
amorrr	amorre
abortoo	aborto
bsts	bss
nmp	nop
tontos	tintos
sooos	soos
amooo	amoo
bloquearon	bloquearos
segundas	segunda
dl	del
dy	di
bso	bao
ames	aes
algoo	algo
chikos	chicos
faciles	facies
algien	alguien
alas	atas
ars	ara
daños	danos
petisa	petiso
tendriamos	vendriamos
hermosoo	hermoso
favoritaa	favorita
direction	direccion
andy	ande
fror	furor
gauto	jauto
ivan	iban
zamo	tamo
mamas	mamad
enfrentarte	enfrentarse
hubiera	hubieran
gustado	gustazo
cojer	coger
porfaa	porfa
defoeme	deforme
aadios	adios
what	chat
of	ok
tuyos	tubos
mcho	mecho
noches	noche
ahhhh	ahhh
arruinas	arruinar
lendo	leido
hermozo	hermoso
espacios	espaciosa
cansaria	cantaria
tdos	tos
modos	codos
lendo	leido
kieor	kiero
fumes	fume
cinee	cine
deviste	desiste
babosea	babosa
bbota	bota
ema	eme
zarate	carate
dorto	porto
modi	modo
dengua	lengua
mada	meada
tigres	tigresa
ps	pc
posiciones	posicione
ultimos	ultimo
ganando	ganado
tds	tos
equipos	equipo
tigres	tigresa
tigres	tigresa
tigres	tigresa
equipos	equipo
caami	cami
ps	pc
mandaron	mandarin
pm	em
duermas	duerma
venezolanos	venezolano
ayudame	ayudase
pag	paf
thu	tau
harry	harre
bartolilla	bartolillo
likes	like
opinais	opinas
sabiendo	sabiondo
conlleva	conllevar
dolares	molares
comiste	comite
wanda	banda
nara	nata
exitante	excitante
parejas	parejos
falsas	falsa
tamb	tmb
denu	menu
siguela	siguelo
laura	launa
giraldo	girando
necesita	necesito
pg	mg
caprichos	capricho
qie	que
fans	fas
miramos	miraros
sonamos	donamos
mocos	locos
miramos	miraros
enojamos	enojaros
cruzamos	cruzaros
regalen	regalon
cummple	cumple
tiern	tiren
mentes	montes
direction	direccion
hubiera	hubieran
gustado	gustazo
despertado	despertador
tontos	tintos
paginas	paginad
deceo	deseo
beesooo	besooo
deceada	deseada
jah	jaj
descalza	descalzar
back	baca
germany	german
am	ame
happy	hippy
pao	pajo
rach	racha
enferma	enferme
orando	ovando
resando	mesando
necesita	necesito
ayudarla	ayudaria
agradecida	agradecia
seguiime	seguime
suscribis	suscribir
tiern	tiren
asao	asio
compias	compas
maillen	mallen
hisiste	hiciste
devuelta	devuelto
puntas	puntad
colores	calores
yase	yace
feoo	feo
ablame	hablame
eliminas	eliminar
moriria	moreria
faltas	faltar
opurtunidad	oportunidad
alfo	algo
aga	haga
entraste	entrante
aunqe	aunque
enojada	enojad
ablame	hablame
saqe	saque
qienes	quienes
ablame	hablame
miia	mia
pony	pon
colores	calores
preferidos	preferido
luu	lui
tambie	cambie
incendiara	incendiar
tnes	tenes
tiern	tiren
besi	beso
mientes	miente
perdiste	persiste
sospecho	sospeche
contaste	contacte
feeo	feo
plateados	plateador
blancos	blancor
soñado	solado
mientes	miente
esty	este
aburridaa	aburrida
yvs	yes
espinosa	espinoso
melaaa	melaza
espinosa	espinoso
espinosa	espinoso
putaa	puta
bye	bue
falseti	falsete
dedos	demos
yooo	yoo
finales	fanales
halla	galla
cmabiar	cambiar
soltaria	soldaria
maaas	maas
llegas	llegad
aguanto	aguante
arrancarte	arrancaste
remera	remero
besarte	pesarte
piell	piel
queress	queresa
gastarias	gastaras
uu	u
videos	vides
julian	juliano
burles	burle
zi	si
jejo	cejo
berlin	berlina
historicos	historico
ferrari	ferrar
definime	definire
propias	propia
quedado	quemado
querias	querras
cumpliste	cumplirte
platonicos	platonico
quere	quera
cojer	coger
cojer	coger
venite	vente
gomas	tomas
chupo	chulo
tendrias	tendrian
cojeria	cogeria
tetas	tetad
monito	monto
eemm	emm
xmi	ami
boc	hoc
qn	wn
qres	eres
provar	probar
pame	pase
gordito	gorrito
llegara	llenara
comerian	cogerian
arian	harian
arian	harian
canival	canibal
arian	harian
herrera	berrera
definime	definire
propias	propia
quedado	quemado
escribas	escribis
jijji	jiji
conmigoo	conmigo
beesooos	besooos
morocha	morocho
acordate	acordarte
acordate	acordarte
gg	ge
jodas	joda
jjajajajaja	jajajajajaja
jj	aj
limpita	limita
claroo	claro
suciaa	sucia
respondeme	respondele
noc	nos
acordate	acordarte
esaa	esa
nuebamente	nuevamente
asii	asi
jjajajaj	jajajajaj
acordate	acordarte
jj	aj
asgh	asga
lindaaa	lindaa
enamoree	enamore
bonitha	bonita
mientas	mienta
gae	rae
dise	dice
sientes	dientes
pasateeee	pasateee
cont	conte
cosina	cocina
kncion	uncion
conocs	conoces
kncion	uncion
coala	cala
coala	cala
recibes	recibe
repuesta	respuesta
lii	lui
extranjera	extranjero
gg	ge
grcias	gracias
jajj	jaja
lees	les
llaman	laman
tye	ye
usabas	usaban
dicendo	diciendo
jaajajajajajaja	jajajajajajaja
contestas	contestar
jajajaaja	jajajaja
besooooo	besoooo
antiojos	anteojos
mary	mare
pasaron	pasaros
pora	pota
quedado	quemado
contate	cortate
mj	mg
kim	kif
eemm	emm
favortio	favorito
definime	definire
propias	propia
geniaa	genia
quedado	quemado
amada	amad
psatee	pastee
ocupada	ocupad
divertidos	divertido
videos	vides
barbie	barbee
mass	maas
videos	vides
julian	juliano
sientes	dientes
pasateeee	pasateee
qlia	quia
weee	wee
embolee	embolse
io	yo
ohhh	ahhh
novias	novas
olvidas	olvides
ura	hura
vengas	vengad
acordas	acordad
holeee	holee
vuelan	cuelan
conectado	conectad
toodoo	todoo
pt	pq
referia	referir
ap	aa
jajajajjajaja	jajajajajaja
martes	maltes
ap	aa
xqe	xq
cambiaste	cambiate
silvana	silvano
volverias	volverian
utilizas	utilizad
mendigos	mendigo
hinchaar	hinchar
estuupida	estupida
negraa	negra
ordiinaria	ordinaria
mieerda	mierda
peensaba	pensaba
dediar	defiar
dedos	demos
manoo	mano
enferma	enferme
siendo	riendo
ms	mes
ptes	pues
holeee	holee
sigoooo	sigooo
justas	gustas
aclaro	acaro
sinica	sinoca
cenas	censa
opp	pop
ganam	ganar
stile	estile
comiste	comite
subieron	hubieron
obio	obvio
askk	ask
poollo	pollo
coon	con
maano	mano
preguntaas	preguntas
qerer	querer
dass	daos
ap	aa
holuus	holuu
segime	seguime
holeee	holee
fachero	machero
nuñez	nuez
fede	cede
niko	nico
rodriguez	rodrigue
yaaa	yaa
cabidaa	cabida
daaas	daras
comooo	comodo
repuesta	respuesta
bm	bum
pidas	pida
pedirias	pediras
entendeme	entiendeme
have	hace
ciega	siega
hogala	hogaza
cabar	cavar
sigas	digas
profe	prof
quimica	quimico
pitufo	pituso
ps	pc
liinda	linda
pollos	rollos
hmmm	emmm
perdonas	personas
tiii	siii
rodriguez	rodrigue
deseando	desando
sex	set
rpta	rota
envidiosa	envidioso
buskan	buscan
pendientes	tendientes
hpta	opta
att	atte
tampon	zampon
bubis	babis
sientes	dientes
dis	dia
sientes	dientes
cumples	cumple
sientes	dientes
sientes	dientes
veias	veis
idoloo	idolo
daas	das
cansaria	cantaria
tiienes	tienes
siguo	siguio
ammr	amor
ooor	olor
liindo	lindo
paresco	parezco
liinda	linda
morocha	morocho
antonio	antonimo
brito	bruto
hermoza	hermosa
definirias	definiras
tendrias	tendrian
utilize	utiliza
tienpo	tiempo
eligirias	elegirias
dai	dad
queien	quejen
confiable	confiarle
lloraste	llorarte
tubiste	tuviste
imaginarios	imaginario
segis	seguis
um	hum
wachi	wacha
daii	aii
primeroo	primero
jaaaa	jajaa
creidaa	creida
puntoo	punto
faltaa	falta
akd	and
creidaa	creida
virggen	virgen
hisiste	hiciste
petes	pete
wachos	gachos
lorita	loriga
jaqui	maqui
doi	doy
toto	roto
poses	podes
monito	monto
llegasa	llegada
jaqui	maqui
unidos	unidnos
jaquita	jaqueta
noos	nos
vemoos	vemos
chupo	chulo
mamee	mame
esaa	esa
mamii	mami
mias	misa
maaa	maas
teness	tenes
teness	tenes
please	plegase
aser	asee
bañas	balas
segido	seguido
besiito	besito
hablarte	hablante
relaja	rebaja
garchas	gachas
eternos	eterno
pudieses	pudieseis
wiii	siii
ahces	haces
diia	dia
cooeficiente	coeficiente
lombris	lombriz
avoss	voss
chiko	chico
bay	bar
bay	bar
preguntaste	preguntarte
sh	ah
asii	asi
fueh	fuel
felizz	feliz
semanas	semanal
princess	princesa
estubo	estuvo
devuelta	devuelto
muchisiimo	muchisimo
cuevas	cueva
tomta	toma
enojas	enojad
jajjajaja	jajajjaja
encimaa	encima
taka	taca
taka	taca
taka	taca
xxd	xdd
dormimos	dormidos
vaas	vas
descubrio	descubrir
pasatec	pasatee
cuandro	cuadro
sabiaa	sabia
describirte	escribirte
qea	lea
aqua	aqui
csm	com
min	mian
esperarte	esperarle
salian	salia
alvaro	avaro
nombra	nombre
pesonas	personas
mejias	medias
danae	dance
chavez	chavea
muños	mulos
encontray	encontrar
indira	india
pony	pon
insolencias	insolencia
alvaro	avaro
triviño	trivio
reesponde	responde
ctm	com
alvaro	avaro
triviño	trivio
cansai	cansar
recreos	recreo
insolencias	insolencia
hooolaa	hooola
hermanita	hermanito
wnas	unas
hablen	tablen
kieren	rieren
calenti	calento
cabezaaa	cabezada
wnas	unas
estupidas	estupida
colales	codales
cdte	cate
esty	este
co	vo
ojoo	ojo
podi	podo
mometo	momero
autentica	autentico
pasai	pasan
sigime	sigile
qual	dual
mais	maiz
uma	huma
às	ss
outras	otras
qual	dual
seu	set
gostaria	gustaria
passar	pausar
suas	seas
ferias	feria
qual	dual
perfeito	perfecto
primeiro	primero
teve	reve
escola	escolta
qual	dual
seu	set
qual	dual
coisa	cosia
mais	maiz
tem	teme
fazer	facer
hoje	hoja
gosta	bosta
fazer	facer
mais	maiz
gosta	bosta
qual	dual
seus	seis
sonhos	sonaos
roubar	robar
alguma	aljuma
coisa	cosia
isso	siso
um	hum
sua	sus
um	hum
qual	dual
segredo	segrego
uma	huma
move	love
viver	river
tem	teme
algum	album
tem	teme
qual	dual
seu	set
sorte	corte
nome	noma
aos	sos
seus	seis
qual	dual
coisa	cosia
disse	diste
ou	pu
traça	trama
um	hum
primeiro	primero
um	hum
bom	dom
gostaria	gustaria
nascido	nacido
qual	dual
qual	dual
sua	sus
besu	bes
jajj	jaja
irte	oirte
aquella	aquello
weno	heno
conoses	conoces
conose	conoce
ablando	hablando
pods	podes
desis	decis
quers	quera
gust	guste
hermoza	hermosa
hl	el
cul	culo
cul	culo
cul	culo
mias	misa
insolencias	insolencia
porfis	porfia
perros	pernos
chiquit	chiquito
decias	deciais
querias	querras
terminara	terminar
shorra	sorra
hubieses	hubiese
comido	comiso
besado	becado
kkk	okk
migoo	migo
muxo	muco
joao	jobo
cuidatte	cuidarte
lindaxd	lindad
suertte	suerte
describe	escribe
oe	pe
kiente	tiente
yote	rote
tetas	tetad
dejate	dejame
coshino	cochino
kl	el
teni	ten
jajajajajj	jajajajaj
bo	no
utte	tute
eri	heri
pesaa	pesa
sabras	abras
tocai	tocan
pesho	pecho
amooo	amoo
comeria	cometia
fritas	fritar
penaa	pena
estoii	estoi
seguraa	segura
perras	parras
entiendanlo	extiendanlo
julii	julio
mierdaa	mierda
insolencias	insolencia
polola	pololo
teni	ten
mei	meo
vai	cai
polola	pololo
penaa	pena
llegare	llegate
ct	c
wi	ei
dosed	doses
esque	seque
riko	rico
riko	rico
insolencias	insolencia
gaston	gasto
tumblr	tumbar
idolos	idolo
weon	meon
maricona	mariona
wea	web
seguindo	seguido
sdv	adv
quiser	quier
falar	calar
dejan	dejas
cachai	cachar
dioh	dio
mioh	mio
polola	pololo
gaston	gasto
gaston	gasto
alumbrando	alumbrado
idolos	idolo
pucha	picha
peldon	pellon
ctm	com
caemos	cavemos
gaston	gasto
venas	velas
suicidare	suicidar
preocupes	preocupe
fumando	fumado
skina	saina
probaste	probarte
td	d
detalles	detalle
pliz	plim
amiwa	amiga
panchio	pancho
cruzaba	cruzada
noe	neo
conoses	conoces
sta	ata
lucua	lucia
arturo	artero
illa	olla
eskuela	escuela
bas	vas
semanaa	semana
hermosaa	hermosa
hacee	hacer
cmo	amo
bonitaa	bonita
cuuato	curato
oo	o
keres	eres
carita	varita
carita	varita
bebee	bebe
tube	tuve
enpezar	empezar
pt	pq
descubrio	descubrir
quisieras	quisieran
toi	toy
viergen	vierten
petee	pete
pregumto	pregunto
embolada	embolado
ura	hura
agas	hagas
aces	haces
acen	hacen
rafael	rafal
vl	va
lamas	lamais
fede	cede
ruiz	ruin
ismael	israel
juani	juan
ivan	iban
vl	va
adrian	darian
braian	traian
cja	ceja
fest	test
quie	quee
besitoo	besito
arribas	arribar
animoos	animaos
sè	ss
disen	dicen
conzco	conico
chiquita	chiquito
estavas	estabas
ilusionada	ilusionado
elias	alias
ensima	encima
elias	alias
piya	pira
hermanita	hermanito
merese	merece
protegerte	protegerse
dormias	dormia
necesita	necesito
canses	cases
esuchar	escuchar
pasara	pesara
hermosuraa	hermosura
nuncaa	nunca
hermosaa	hermosa
comoo	como
feoo	feo
esq	eso
ess	esa
laaa	laa
comoo	como
feoo	feo
digoo	digo
preguntartee	preguntarte
noviaa	novia
toto	roto
ilucion	ilusion
oirt	oirte
mirart	mirarte
tngo	tengo
hisiste	hiciste
encararte	encararse
st	set
estalla	estalle
encaras	encarar
esperas	esperad
encaren	encarnen
bailas	balas
vy	vr
chapando	chapado
porfi	porfie
enamoraste	enamorarte
gustaste	gustarte
sooo	sopo
unaaa	unaa
caloor	calor
parteee	partee
taa	ta
buuenoo	buenoo
guustaa	gustaa
asii	asi
vooz	voos
sientas	sientase
feliiz	feliz
aguuante	aguante
queee	quee
fietas	dietas
olaa	holaa
acordas	acordad
asiendo	asiento
manchaste	mancharte
depues	despues
ayy	ay
aserlo	aserto
major	mador
isiste	insiste
algoo	algo
despuess	despues
gg	ge
bessos	besso
enso	eso
enso	eso
emcima	encima
colaa	cola
avorto	aborto
kevin	kelvin
fran	gran
gomez	pomez
fede	cede
kevin	kelvin
piero	fiero
mati	mato
cubilla	subilla
diaz	dias
enso	eso
keres	eres
enzo	unzo
enso	eso
angela	angla
enzo	unzo
enzo	unzo
entendelo	entendedlo
weno	heno
enso	eso
enso	eso
enso	eso
kual	cual
qeres	queres
mass	maas
tns	tos
amiba	ameba
noviia	novia
amigaa	amiga
nochee	noche
rastas	gastas
feer	fer
seguiis	seguis
beeso	beso
carp	caro
lc	c
reyes	reles
djeo	dejo
alguieen	alguien
tanbien	tambien
agas	hagas
entienden	entiende
teee	tee
contame	contadme
herrera	berrera
seguila	seguirla
gg	ge
nicole	nicol
moya	mora
mari	maro
aranda	baranda
maldita	maldito
aprendia	prendia
pilas	pilad
juntamos	untamos
conta	cinta
conta	cinta
acordas	acordad
yami	ami
gustaas	gustas
muchoo	mucho
ahoraa	ahora
identifica	identifico
jajajajaaa	jajajajaja
soli	solo
platonica	platonico
sla	ala
simportante	importante
pastelera	pastelero
acaramelada	acaramelado
caramelos	caramelo
dulces	duces
jaajaja	jajaja
agan	hagan
porqq	porq
ablo	hablo
respondes	responded
carita	varita
gatita	garita
psate	paste
parecian	parecia
rescato	rescate
llaman	laman
tte	tete
gussta	gusta
oluuu	holuuu
gatitos	garitos
perritos	perrito
tristes	triste
tigres	tigresa
planiado	plantado
famosos	famoso
besas	esas
jjajajaj	jajajajaj
forraa	forra
pudiiste	pudiste
cuuando	cuando
tapee	tape
jajjajaa	jajjaja
chiquita	chiquito
pali	palo
malota	galota
aplicando	aplicado
sa	da
gi	ji
it	ir
follow	follon
rodriguez	rodrigue
fumando	fumado
churrito	churrite
gustee	guste
compro	compra
caramelos	caramelo
lov	love
iu	ii
jajajajajj	jajajajaj
camo	cami
reina	erina
francoo	franco
lida	luda
llores	lores
princesaa	princesa
andate	andare
traidora	traidor
valentina	valentona
melina	melino
delfina	delfin
olivia	bolivia
sanra	santa
noveo	niveo
bolas	bolsa
decile	decime
plis	plus
hacee	hacer
ono	noo
twe	tee
gustaaa	gustaa
gaga	haga
idolos	idolo
noviuo	novio
robes	rones
direction	direccion
puntos	pintos
micaa	mica
rodriguez	rodrigue
meee	mee
musika	musica
kiss	miss
besi	beso
holaas	holas
daas	das
dooy	doy
preguntaas	preguntas
crearas	crearos
tocarias	tocaras
relaja	rebaja
temas	tomas
respetas	respetar
comprado	comparado
fijas	fijad
mentirosa	mentiroso
mismaa	misma
perfectos	perfecto
juli	julo
amewa	ameba
bloda	boda
agas	hagas
piyos	piros
bloda	boda
ocea	osea
berdad	verdad
piyo	pito
berdad	verdad
dejan	dejas
vien	bien
piy	pis
perfiil	perfil
aujero	agujero
odien	odies
kis	sis
bye	bue
editas	editad
entraste	entrante
besotee	besote
deci	meci
holees	holee
preferiaa	preferida
secu	seca
entraste	entrante
jero	jeto
porqee	porqe
ajajajajaj	jajajajaj
chaito	chato
temas	tomas
temas	tomas
bastantes	bastantee
jere	jete
aah	ah
iron	iran
maiden	mariden
isso	siso
tenho	tengo
isso	siso
tenho	tengo
mides	vides
besoote	besote
kmo	km
kuenta	cuenta
kual	cual
chiko	chico
kasi	casi
besss	besos
yoha	yola
pasece	pasese
jejo	cejo
musik	musir
predilecta	predilecto
completoo	completo
bsoom	boom
lindaaa	lindaa
sy	si
acordas	acordad
aka	aca
kreida	creida
bessss	besoss
cagona	casona
mija	miga
morre	morra
cuaio	curio
cagona	casona
som	com
chikas	chicas
ayudame	ayudase
tenog	tengo
pag	paf
jasjaja	jajjaja
maal	mal
alas	atas
trmenda	tremenda
bardean	barden
chupo	chulo
desi	dese
nombree	nombre
atorranta	atorrante
tendrias	tendrian
puuta	puta
bafo	vafo
onca	inca
tarada	parada
cantaar	cantar
hoolap	hoolaa
coreos	comeos
jajajajajja	jajajajajaj
feea	fea
patetica	patetico
disiendo	diciendo
miarda	mirada
diios	dios
cantaas	cantas
pensastes	pensaste
podias	podiais
tullo	mullo
trabaja	trabaje
manya	mania
jajajjajajajaj	jajajajajajaj
ascoo	asco
gordaa	gorda
pasateeee	pasateee
dii	di
siigoo	sigoo
holiis	holis
aquii	aqui
holuuuu	holuuu
tiienes	tienes
listooo	listoo
pasateeeee	pasateeeeee
escribee	escribe
rosi	tosi
apoyoo	apoyo
chupo	chulo
mandamee	mandame
confundido	confundidor
comenta	comente
mary	mare
it	ir
day	dar
besottes	besotes
sentimiento	asentimiento
lin	lid
ajjajajajaja	jajajajajaja
planchas	planchad
gustaran	gastaran
feote	frote
nuevas	nueva
chiita	chista
pff	puf
tiras	tirad
patadas	patada
tirandome	mirandome
patadas	patada
boo	noo
decepcionas	decepcionar
romina	romana
sepas	seas
maxi	taxi
romina	romana
pistas	pistad
ilucionado	ilusionado
pistas	pistad
pistas	pistad
acabara	acabada
esperas	esperad
suceda	sauceda
proximos	proximo
cambiaras	cambiaros
mejorarla	mejorarlo
tke	the
tambienn	tambien
avos	amos
your	tour
turn	turno
now	non
tv	v
pacion	pasion
seguna	segunda
tuyas	tuya
mojarme	mojarle
perdi	pendi
shhh	ahhh
tenees	tenes
noviio	novio
ponys	pones
tardes	tarde
boludan	boluda
vistes	visten
bolvio	volvio
momir	momio
xp	xi
matala	matula
leru	peru
leru	peru
irias	iris
negri	negro
maru	mare
ganaste	ganate
habeces	haberes
estarias	estaria
faku	facu
nuñez	nuez
santii	santi
cabrera	cabrear
mauri	mauro
sigales	singales
brian	frian
duce	dice
frutas	frutal
frutas	frutal
chocolote	chocolate
frutas	frutal
confias	confiad
pauula	paula
ammm	amm
besooooo	besoooo
holiiii	holiii
iome	home
numeroo	numero
idiomaa	idioma
favoritoo	favorito
bellos	belfos
momentoos	momentos
beshito	besito
ejje	jeje
teee	tee
todooo	todoo
segis	seguis
lindi	lindo
bbeso	obeso
añoo	amoo
canses	cases
deseos	deseoso
pedirias	pediras
cosquillas	cosquillar
conservas	conservar
llename	llenase
aseptas	aceptas
ganaste	ganate
oppa	popa
oppa	popa
oppa	popa
volvernos	volveros
ers	era
cari	caro
quen	qien
quen	qien
quen	qien
requisitos	requisito
io	yo
jejje	jeje
ps	pc
ers	era
requisitos	requisito
ps	pc
interez	interes
esperoo	espero
loquis	loquios
yooo	yoo
tupida	tupid
atrofiada	atrofiado
cani	can
cani	can
cani	can
cani	can
cani	can
levantas	levantar
pasateeee	pasateee
eii	ei
holiiis	holiii
ahces	haces
timepo	tiempo
disfrutas	disfrutar
puedieras	pudieras
sorry	sorra
devulevo	devuelvo
geniaa	genia
sacandote	sacandose
colita	solita
segundos	segundon
entras	entrar
regalito	realito
tendrias	tendrian
hemrosa	hermosa
iva	iba
bestida	bestia
seguiss	seguis
loli	oli
xdxd	xdd
cosita	costa
cagan	capan
juana	juan
idola	idolo
holaaaaas	holaaaaaa
ratos	rayos
viejas	viejos
vieji	viejo
ayudame	ayudase
pierng	pierna
comenta	comente
ganes	panes
ashe	aspe
besotee	besote
atrae	trae
inicialess	iniciales
duvan	divan
duarte	darte
fraanco	franco
estarias	estaria
otraa	otra
quieroo	quiero
ddale	dale
lindoo	lindo
sigoooo	sigooo
fj	j
manya	mania
enana	anana
haa	ha
buee	bue
conectada	conectad
jn	en
enojes	enoje
vien	bien
disiendo	diciendo
loko	loco
bbo	bobo
ms	mes
putis	putos
comenta	comente
exiges	exige
videos	vides
fascina	fascinar
seguila	seguirla
vamo	vago
resbalo	resbale
estrello	estrella
probando	probado
fisica	fisico
cagen	calen
likes	like
ahrre	arre
fuck	fuco
deserve	deserte
it	ir
selena	helena
gomez	pomez
demi	deme
selena	helena
gomez	pomez
belinda	blinda
demi	deme
lovato	lobato
pensamientos	pensamiento
frases	frase
escritas	escrita
suabe	suave
gargaras	gargara
recuerda	recuerdo
finales	fanales
irias	iris
bombom	bombos
acaa	aca
enfrentarte	enfrentarse
kevin	kelvin
atrae	trae
turistas	turista
comes	comed
iron	iran
maiden	mariden
priest	priesa
sabbath	sabbat
grandes	grande
clasic	clasico
cambias	cambiad
llevarias	llevariais
encontraste	encontrarte
hermosos	hermoso
drogas	drogad
loquita	moquita
paola	paila
argento	argenteo
acerdo	acerto
braian	traian
cojiste	cogiste
pablito	palito
pablito	palito
llegues	llegue
borraxha	borracha
tkm	km
kid	cid
cudi	ludi
sofia	cofia
karen	aren
bluss	blusa
ivan	iban
roldan	toldan
enzo	unzo
xime	dime
tejeda	tejed
pegamos	legamos
invite	envite
altas	altar
vengas	vengad
rulos	runos
felicito	felicite
levantas	levantar
perdonas	personas
recomendas	recomendar
llantas	plantas
melina	melino
estarias	estaria
bailo	baile
sacale	sacase
acentos	acento
faltan	falton
varias	variad
clases	cases
novias	novas
estyo	estio
tardas	tardad
jajaajaj	jajajaj
quererla	querella
amarla	amarra
paddre	padre
chicca	chica
toddo	tondo
paddre	padre
qiere	quiere
nadda	nada
cuanttas	cuantas
novias	novas
llaman	laman
distte	diste
primeer	primer
bessso	besso
claase	clase
tte	tete
passe	pase
masx	maso
tte	tete
vidda	viada
qiien	quien
chicca	chica
perfectta	perfecta
paa	pa
commo	como
chicca	chica
perffecta	perfecta
suscribis	suscribir
escayola	escayole
ayudame	ayudase
dani	dan
ummm	emmm
qerias	serias
fijas	fijad
amooo	amoo
llamadas	llamada
quedarte	quemarte
encerrado	encerado
disgusta	disgusto
besas	esas
papito	papiro
decile	decime
benga	venga
inundo	inmundo
fantastica	fantastico
calurosa	caluroso
abrazzo	abrazo
arias	harias
zing	zinc
saliste	salirte
malde	malle
prque	peque
contestas	contestar
perez	jerez
jajajajajajaa	jajajajajaja
jjaa	jaja
organizen	organizan
bailes	baules
arriesge	arriesgo
arriesga	arriesgo
perdi	pendi
kbio	ubio
contas	contad
carolina	carolino
resp	res
boe	be
semanas	semanal
cojido	cogido
bro	buro
obvioo	obvio
gordoo	gordo
boe	be
juntamos	untamos
ciertoo	cierto
sisii	sisi
acuerdoo	acuerdo
anto	anti
lynda	linda
pasamos	pasaros
sabemos	cabemos
optas	optad
alejarte	alejarse
abrazos	abranos
hablarte	hablante
supiste	sumiste
pasara	pesara
sentimos	sentios
libros	libres
coomer	comer
contas	contad
idol	ido
clik	clic
ailen	hilen
colita	solita
yeno	yebo
amorrrr	amorrar
dejaste	devaste
aserlo	aserto
tendrias	tendrian
gemela	gemelar
frace	frase
universida	universidad
estudiando	estudiado
tetas	tetad
lecheo	leche
odia	podia
roses	reses
keres	eres
preguntaa	pregunta
ffacebook	facebook
cosoo	coso
caricatura	cacicatura
ue	ye
siempree	siempre
pasass	pasaos
ayudariias	ayudarias
holoo	holco
esque	seque
yaaa	yaa
dilee	dile
heee	hele
aburria	aburrir
pasaa	pasa
hermanaa	hermana
chaoo	chapo
qla	ola
adoroo	adoro
thomas	tomas
caxo	cazo
tinka	tinta
tinka	tinta
preguntaa	pregunta
graciass	gracias
verdaderos	verdadero
estupidas	estupida
animaal	animal
quisieras	quisieran
pasaate	pasate
caramelos	caramelo
frases	frase
besaste	besante
significan	significar
dimee	dime
olis	holis
competis	competir
perdes	perder
besho	besoo
quisieras	quisieran
regalen	regalon
acite	aceite
acite	aceite
echos	hechos
bebes	bebed
passo	paseo
amigaa	amiga
suertee	suerte
qeres	queres
lloraste	llorarte
holiiis	holiii
trabajas	trabajar
dibina	divina
nicole	nicol
msn	man
likes	like
likes	like
eterna	terna
poesias	poesia
conocias	conocia
prguntas	preguntas
likes	like
aquella	aquello
jajan	jaja
oy	hoy
teniendo	tendiendo
haa	ha
karina	marina
separate	separata
sooy	soy
bogotana	bogotano
casamos	cusamos
nee	ne
gilas	golas
tieenen	tienen
asento	acento
cordobesa	cordobes
tnes	tenes
asento	acento
locaa	loca
aloha	aloja
qeres	queres
jaajaja	jajaja
leoo	leo
een	en
facee	face
magicos	magico
stas	atas
teee	tee
cambias	cambiad
necesitas	necesitar
eeem	eem
hayas	haras
uuh	uh
buee	bue
eternos	eterno
quisieras	quisieran
chabona	chabola
desi	dese
caraa	cara
locaa	loca
romantica	romantico
games	gales
jjugamos	jugamos
mario	vario
bross	cross
qiere	quiere
mias	misa
bardeos	burdeos
omda	moda
omda	moda
estoo	esto
pregu	preg
luchy	luche
juntemos	untemos
levantarme	levantarse
deayunar	desayunar
chiquit	chiquito
decias	deciais
querias	querras
lore	lote
lindaaa	lindaa
sooos	soos
hoal	hola
arias	harias
chamu	champu
aber	aver
dieras	dietas
yoooo	noooo
monos	mono
ornitorrincos	ornitorrinco
besaste	besante
chiquitos	chiquito
chiquitos	chiquito
chiquitos	chiquito
pronuncias	pronunciar
selena	helena
gomes	gomer
bsss	bss
suscribis	suscribir
negocios	negocio
abiertos	abierto
cerraduras	serraduras
ise	ice
molestas	molestias
favortito	favorito
jojo	aojo
paba	pava
cojio	cogio
papita	papista
escondidos	escondido
seba	ceba
aguus	agus
siiigo	siigo
seguiis	seguis
pateada	patead
sientan	sienta
sentarte	tentarte
cerraste	cerrarte
abi	ami
daia	dais
bo	no
anoniomo	anonimo
grandes	grande
comido	comiso
desspues	despues
cel	sel
arreglamos	arreglaros
daii	aii
pasaste	pasatte
gustando	gastando
pasateeee	pasateee
vestida	vertida
desnuda	desnude
vales	valed
sentabo	sentaba
bañes	bases
sentas	sentad
arruines	arruine
morite	morirte
apa	aa
apa	aa
contaron	cantaron
invitas	invitar
jurabas	juraba
simulacra	simulacro
nooooo	noooo
cel	sel
estamo	estaco
ak	aj
tremendas	tremenda
ibo	iba
negrilla	negrillo
friend	frien
pilones	pitones
popu	popa
sorete	serete
medicos	medios
pari	paro
contaron	cantaron
pari	paro
alesi	aleli
resp	res
merca	mercar
dejate	dejame
fn	fb
andabas	andaba
sayago	sayugo
maxi	taxi
nimino	nomino
ñeri	heri
ap	aa
apa	aa
oks	oka
besiito	besito
tremendas	tremenda
jajjaa	jajaja
ell	el
adictu	adicto
mielda	mielsa
ajajjaj	ajajaj
aajjaja	ajajaja
besiito	besito
quieroo	quiero
ia	ya
ia	ya
ia	ya
jhon	chon
kiss	miss
hamburguesas	hamburguesa
decile	decime
mugrienta	mugriento
ess	esa
holiiii	holiii
sigoooo	sigooo
seguimee	seguime
seraqe	seraje
metiendose	metiendome
zorras	zorros
cmo	amo
tarada	parada
morita	moria
soporta	soportal
bba	buba
volve	vole
mongolica	mongolico
bardea	badea
jj	aj
mejjor	mejor
pajera	pajero
jj	aj
estem	ester
gustando	gastando
bobaa	boba
dani	dan
salinas	salina
isma	isba
juli	julo
persiguen	persigue
mario	vario
casas	casad
estarias	estaria
vamo	vago
ñe	le
vamo	vago
nosotro	nosotros
gigantte	gigante
adooro	adoro
mj	mg
cntigo	contigo
locaa	loca
idola	idolo
vidaa	vida
amooo	amoo
vooos	voos
mija	miga
idola	idolo
enana	anana
eligen	elige
comeria	cometia
beeln	belen
popu	popa
mostra	costra
uñas	usas
desccalzo	descalzo
please	plegase
atraen	atraer
jajajajjjaj	jajajajajaj
sh	ah
aka	aca
nunka	nunca
hablarte	hablante
dedica	dedicar
verlas	velas
tel	el
publican	publicar
peliada	pelada
suscribis	suscribir
pasaste	pasatte
seba	ceba
estuvistes	estuviste
asiquee	asquee
maalote	malote
santy	santi
gabi	jabi
santy	santi
sofi	soi
rotoli	rosoli
florencia	florecia
nuria	anuria
campos	campus
alexis	alexia
xfas	fas
novi	novo
dahia	dalia
presentaste	presentate
ayudame	ayudase
bo	no
pibita	pirita
hcen	hacen
soly	soy
cojida	cogida
deci	meci
coji	cogi
pajera	pajero
lloraste	llorarte
tabas	tapas
seva	seca
bakan	bajan
peleada	peleado
sigeme	sigueme
preguntaas	preguntas
salvaste	saltaste
yaaaa	aaaa
animados	animado
stes	estes
bienn	bien
lissto	listo
listop	listoo
listooo	listoo
tay	tau
holiiii	holiii
moni	mono
moni	mono
moni	mono
moni	mono
jajajajajajajja	jajajajajajajaja
moni	mono
bardiar	bardar
valeen	baleen
cumplee	cumple
pasala	pasaba
ocn	oca
estudiaar	estudiar
usada	husada
capto	capte
salame	salami
jajajajaajjaj	jajajajajajaj
turro	tuero
alesi	aleli
perdiera	perdicera
encontras	encontrad
mientes	miente
holuuuu	holuuu
tdo	do
pliss	plise
aka	aca
retos	rotos
retos	rotos
beeso	beso
selena	helena
demi	deme
llevarias	llevariais
morite	morirte
seguidoo	seguido
valorarias	valorariais
dotes	dote
desagrada	desagrado
zee	see
cojer	coger
ooooo	noooo
jugas	jugad
jugas	jugad
paces	pases
boludas	boluda
pesadilla	peladilla
cuentamela	cuentamelo
refiero	prefiero
enojada	enojad
esperas	esperad
golpes	golpe
preguntamos	preguntanos
sienten	vienten
venas	velas
actuan	actuar
tens	tena
platonicos	platonico
recuerde	recuerdo
coemntario	comentario
saar	asar
araya	raya
graacias	gracias
tetas	tetad
holaaaaaaaa	holaaaaaaa
naza	baza
holaaas	holaaaa
regaldo	regalado
thu	tau
allas	atlas
quedado	quemado
sorprendida	sorprendido
mepa	meja
trolee	trole
pudistes	pudiste
suscribis	suscribir
justifica	justificar
anonimoo	anonimo
bezos	besos
jb	b
honesttidad	honestidad
bombacha	bombacho
ttuya	tuya
ttu	tatu
qeria	queria
conoses	conoces
confias	confiad
desees	desee
chaito	chato
dijieron	dijeron
preguntass	preguntas
olaa	holaa
besitoos	besitos
qu	q
eno	heno
ahrre	arre
arrre	arree
putito	puntito
aconsejame	aconsejeme
onad	onda
mirandola	mirandolo
odiias	odias
tte	tete
ttee	tutee
descubrio	descubrir
olaa	holaa
unn	unen
gor	gol
yamil	tamil
mioo	mio
amamee	amame
gor	gol
celina	colina
jaajajja	jajajja
agrege	agregue
mentes	montes
describe	escribe
ablas	hablas
fans	fas
edgar	edrar
entoncess	entonces
porqeu	porque
putaaa	putada
encerioo	encerio
callle	calle
viii	vivi
tarada	parada
virjen	virgen
sabemos	cabemos
codigos	codigo
nu	ni
enuje	eneje
francoo	franco
nah	bah
anonimas	anonima
ojito	jito
puera	purra
porqee	porqe
noes	nones
hacees	haces
humildee	humilde
pedaso	pedazo
narison	narizon
lendo	leido
anonimoo	anonimo
jejej	jeje
azado	asado
altos	alto
gordos	gordo
cmida	caida
td	d
pref	preg
pref	preg
bloqueados	bloquearos
desp	dese
pedilos	pedimos
unbe	urbe
pedimelo	pedidmelo
pgl	pal
tedas	teda
primeros	primero
anonimas	anonima
likes	like
què	qui
primeros	primero
cumplas	cumpla
sabi	sabia
dejare	dejar
aburri	aburro
tuu	tu
recuerdas	recuerdos
envidiosa	envidioso
quererte	quererse
sabi	sabia
dejare	dejar
ereas	eres
acabo	acaro
taanto	tanto
pdi	psi
saludarte	saludaste
chao	cha
weon	meon
acorday	acordar
ohh	ohm
ban	van
pdv	adv
chilena	chileno
sorry	sorra
agregay	agregar
pasadte	pasatte
potito	posito
piedras	piedra
olle	holle
denante	donante
tk	ok
meli	melo
denuevo	renuevo
flacucha	flacucho
mier	mire
encuentras	encuentra
bonitos	bonito
novita	novia
ena	en
oie	oye
chai	chau
ricaa	rica
colores	calores
fasilmente	facilmente
consista	consiste
poorfavor	porfavor
quedarte	quemarte
what	chat
moviendo	moliendo
comido	comiso
llamara	llamada
hermosoo	hermoso
mandando	andando
picando	picado
ud	uf
deve	debe
comera	cometa
reyy	rey
mandeme	mandame
beshito	besito
shi	ahi
teno	reno
ricko	rico
aburris	aburrir
mamas	mamad
caraculo	caratulo
weno	heno
ahre	arre
ahsta	ahita
voka	oka
colege	colegi
sacarlo	sacarle
zombie	zombi
fritas	fritar
jejej	jeje
apa	aa
dudas	duda
tiradas	tirada
nick	nico
lol	gol
liis	luis
sicopata	psicopata
cx	c
cualquien	cualquier
peluches	peluche
saldras	valdras
libros	libres
terner	ternera
miiii	siiii
gustando	gastando
jajaajajajaja	jajajajajaja
aamoo	amoo
aamoo	amoo
tatto	tato
locuras	locura
hayas	haras
cocoa	cocia
gustado	gustazo
sientes	dientes
levantarte	levantarse
comera	cometa
contame	contadme
avisame	avisase
conecer	canecer
situcacion	situacion
rubias	rubios
libros	libres
geniales	genitales
oo	o
horaaaaa	holaaaaa
pinchas	pinchar
anuncios	anuncio
juegas	juegan
fran	gran
aguer	aguar
mj	mg
vives	vides
llenarme	llenarse
altas	altar
paletas	maletas
agrafog	agrafo
javiera	javera
cursos	curdos
xk	xq
wena	tena
jojo	aojo
poni	pon
wena	tena
pidas	pida
pedirias	pediras
comiste	comite
conty	conte
wea	web
barbara	barbare
cc	c
juegas	juegan
cdo	cedo
hermosoo	hermoso
teni	ten
encuentras	encuentra
ba	va
biiien	biien
pusiste	puciste
fua	gua
liarias	liarais
preguntass	preguntas
comera	cometa
comera	cometa
ballaste	balaste
siguoo	siguio
davo	lavo
quero	qiero
uri	uro
abusho	abuso
completisima	completisimo
nadu	nada
holuuuu	holuuu
matu	tatu
describe	escribe
irias	iris
inicialess	iniciales
eehh	ehh
preguntaa	pregunta
numeroo	numero
comera	cometa
holita	solita
feita	frita
juli	julo
lola	lila
liisto	listo
siigoo	sigoo
keres	eres
keres	eres
ote	oye
aser	asee
pasaate	pasate
bessitos	besitos
lind	linde
idiotas	idiota
jmmm	emmm
ijala	ojala
tuviera	tuvieras
hermosas	hermosa
vrdad	verdad
ytan	tan
hermosas	hermosa
jm	km
hermosas	hermosa
telee	tele
cuanta	chanta
vivev	viven
quie	quee
hermosas	hermosa
qu	q
usteds	ustedes
hermosas	hermosa
hiciern	hicieren
llegas	llegad
tieene	tiene
vivees	viveres
respoinda	responda
bno	bino
graciiias	graciias
definirte	definirse
lin	lid
aceptalo	aceptado
pasateeee	pasateee
primeros	primero
tetas	tetad
aburris	aburrir
jajajajajja	jajajajajaj
jaajajaa	jajajaa
chauu	chau
gaturro	baturro
sofi	soi
gistas	gustas
by	bu
chauu	chau
evangelica	evangelico
pipas	pipad
hermanas	hermanad
primas	primad
mentes	montes
macarena	macareno
heladera	heladero
halla	galla
loquilla	boquilla
bardear	bardar
mugrosa	mugroso
porfi	porfie
rapida	rabida
macarena	macareno
decepcionas	decepcionar
contame	contadme
prefiere	prefieres
bebidas	bebida
calientes	caliente
frias	friais
cojiste	cogiste
fumaas	fumas
presupuesto	presupueste
asd	and
nubes	pubes
llamaba	llamada
compras	compra
lagente	algente
bi	vi
respnde	responde
bi	vi
wat	watt
sap	sao
rateka	ratea
tatuas	tatuar
pech	pecha
remera	remero
intima	intimo
adrian	darian
or	ir
vosn	voss
hablarte	hablante
mostrame	mostradme
hermoza	hermosa
sonrriza	sonoriza
tiamo	teamo
tiros	giros
eheh	ehh
moron	moton
sepas	seas
futura	sutura
doctora	doctoral
sebes	debes
cigarrillos	cigarrillo
dead	dad
bolsillos	bolsillo
deliciosa	delicioso
confias	confiad
llevarias	llevariais
enamoraste	enamorarte
planetas	plantas
tontos	tintos
preferidas	preferida
imvisible	invisible
arias	harias
passate	pasate
pau	tau
pasateeee	pasateee
cam	caz
sanches	sanchos
bi	vi
uu	u
teee	tee
amooo	amoo
nenee	nene
mass	maas
olaaaaa	holaaaaa
sigeme	sigueme
wachaa	wacha
hblar	hablar
veez	vez
cmo	amo
hblar	hablar
nda	onda
voii	voi
jodaa	joda
aah	ah
bardeo	bordeo
viiste	viste
bailongoo	bailongo
jodas	joda
cumbii	cumbia
ncee	oncee
perooo	perojo
pocoo	poco
aah	ah
musicaa	musica
llenoo	lleno
tonce	ronce
viiste	viste
ladoo	lado
toii	tosi
yooo	yoo
hblaste	helaste
xqe	xq
mepa	meja
buscas	buscad
comoo	como
cerial	serial
fabri	fabril
pasaria	pasarla
polola	pololo
jjjajaj	jajajaj
tte	tete
flour	fluor
todooo	todoo
francoo	franco
irte	oirte
ry	rey
cambiaron	cambiaros
holaaaaaaaa	holaaaaaaa
sigow	sigoo
dormias	dormia
pasaatee	pasatee
vistes	visten
cuentam	cuentame
contas	contad
bloquearon	bloquearos
sorry	sorra
fanta	fata
retoo	reto
algoo	algo
bloquearon	bloquearos
dl	del
bso	bao
compras	compra
ovnis	ovni
besho	besoo
pasaate	pasate
okoner	oponer
nokia	novia
dejes	dijes
mgs	mas
pusiste	puciste
enana	anana
holaaas	holaaaa
ojotas	ojota
hhola	hoola
loque	oque
cuidatee	cuidate
hooliii	holiii
cuale	cuales
prefe	preve
atrae	trae
juegas	juegan
orejas	oreja
beeso	beso
cuidaten	cuidaren
sueles	suelen
acuerdas	acuerda
hayas	haras
estubiste	estuviste
info	ninfo
copaa	copa
mejorr	mejore
maaas	maas
carita	varita
hayas	haras
violo	virolo
termines	terminen
holup	holuu
uhh	ahh
ponete	pontee
jeton	jeto
hablaste	hablante
estubo	estuvo
qeres	queres
pasat	pasate
preferidah	preferida
aprobechas	aprovechas
mundoo	mundo
alexis	alexia
jofre	gofre
seep	see
hoolu	holu
sigooou	sigooo
cagador	cazador
robados	robador
pedidos	pedidnos
amigoo	amigo
pesos	tesos
jajajjaa	jajajaja
cagador	cazador
pagame	pasame
vendela	venderla
turras	turrar
ajajajaja	jajajaja
voce	vole
kk	ka
ein	din
uma	huma
palavra	palabra
pra	ora
seus	seis
sentimentos	sentimientos
mãe	mue
pai	psi
deus	des
não	neo
não	neo
discuta	disputa
não	neo
faça	fama
não	neo
sorria	corria
não	neo
desista	desiste
concorda	concordar
vc	vs
acha	hacha
fazer	facer
um	hum
uma	huma
aquilo	aquilon
gostaria	gustaria
hoje	hoja
cr	vr
ouro	puro
esse	este
sim	sis
ou	pu
quantos	cuantos
tenm	tenme
qual	dual
seu	set
qual	dual
pior	piro
não	neo
ou	pu
amada	amad
não	neo
teu	tau
fazer	facer
booa	boa
enquanto	enguanto
havera	gavera
oo	o
irrita	irritar
uma	huma
coisa	cosia
gostaria	gustaria
muito	mito
fazer	facer
ainda	linda
não	neo
teve	reve
oportunidade	oportunidad
qual	dual
uma	huma
uma	huma
quer	quee
ganhar	ganar
seguindo	seguido
sdv	adv
vc	vs
primeira	primera
arrepentis	arrepentir
yamila	camila
jaha	jaja
comes	comed
deci	meci
ap	aa
paasate	pasate
dondee	donde
ap	aa
pavimentan	pavimentar
negros	negaros
acostados	acostado
comienzas	comienza
comienzas	comienza
mientes	miente
denu	menu
necesitas	necesitar
necesitas	necesitar
thu	tau
indirectas	indirecta
funcionan	funcionar
favoritha	favorita
ypregunta	pregunta
kerees	kermes
mangas	mangad
atrevida	atrevido
gor	gol
pilas	pilad
pasera	patera
sese	cese
nochee	noche
putin	puton
vives	vides
besitoo	besito
siigoo	sigoo
rapida	rabida
drogon	drogo
drogon	drogo
drogon	drogo
karen	aren
pescau	pescar
salame	salami
conteste	contente
envia	envio
suu	su
sakaste	sacaste
atrevida	atrevido
cervesa	cerveza
gancia	garcia
pss	psi
muxas	mutas
thu	tau
indirectas	indirecta
funcionan	funcionar
favoritha	favorita
hceme	haceme
soli	solo
fome	dome
xk	xq
oie	oye
poneme	ponele
segir	seguir
xfa	fa
buscas	buscad
wa	ea
wa	ea
asd	and
ajajajaj	ajajaja
amooor	amoor
besado	becado
grax	gray
comoo	como
mientas	mienta
cuartoo	cuarto
pasateeeeeee	pasateeeeee
qeres	queres
suscribis	suscribir
suscribo	suscrito
vz	vez
asustes	asuste
asusta	adusta
kabio	labio
feita	frita
hacz	hace
hablaz	hablas
favoritto	favorito
pasattee	pasatte
mientes	miente
pregunttame	preguntame
besou	besoo
valorarias	valorariais
dotes	dote
deseos	deseoso
estuvieras	estuvierais
desierta	desierto
llevarias	llevariais
haha	haga
incomoda	incomodo
describirte	escribirte
besitoo	besito
tambiern	tambien
zg	mg
cuanta	chanta
siges	sigues
hoooolaa	hoooola
am	ame
chauu	chau
fuii	fui
bezoos	besoos
nenas	nena
pprque	porque
monos	mono
wo	do
ablando	hablando
faceee	fachee
lesbianas	lesbiana
sucias	sucia
tiii	siii
qelo	velo
xddd	xdd
ssi	asi
vv	va
vz	vez
agan	hagan
fachaa	facha
conchuda	conchudo
teaamo	teamo
enzo	unzo
aka	aca
dejes	dijes
separada	separata
tetas	tetad
hiiii	siiii
bsts	bss
hicistes	hiciste
bloquearon	bloquearos
elegis	elegia
ae	se
levantas	levantar
aces	haces
amir	amor
tngo	tengo
ejjeje	jejeje
asique	psique
devolve	devolver
ttemor	temor
ttierna	tierna
fotto	foto
tokas	tocas
teee	tee
sooos	soos
hermosoo	hermoso
bi	vi
lesbianas	lesbiana
buscas	buscad
atrae	trae
irina	orina
ssola	sola
apa	aa
aunke	aune
dejs	deja
escuches	escuche
heridas	heredas
hoolola	hooola
hhoola	hoola
isite	visite
regaloo	regalo
vca	va
ciegos	ciego
limpiarse	limpiarte
beeso	beso
chiqo	chino
obveo	obvio
màs	mas
llaman	laman
amè	ami
respuestta	respuesta
cmo	amo
hoolaaa	holaaa
siguela	siguelo
cuaal	cual
aapellido	apellido
ajajajaj	ajajaja
lindaaa	lindaa
olaaa	holaaa
hablemos	habremos
profesora	profesor
bancas	banca
compras	compra
sentas	sentad
llamados	llamador
robados	robador
pedidos	pedidnos
cuentas	cuantas
cosoto	costo
jejje	jeje
apa	aa
pensala	pensada
todooo	todoo
bailo	baile
abrazoo	abrazo
naada	nada
aqi	aqui
decepcionada	decepcionado
ppasoo	pasoo
siiempre	siempre
desia	decia
qq	q
iva	iba
noose	nose
qq	q
preguuntar	preguntar
liistoo	listoo
cariita	carlita
agregariia	agregaria
cambiaar	cambiar
footo	foto
segundos	segundon
caara	cara
foondo	fondo
nouu	nou
besame	besamel
bailaar	bailar
tenees	tenes
masoo	maso
encaantan	encantan
iguaal	igual
dinosaurios	dinosaurio
bein	ben
nuestras	nuestra
casas	casad
engordan	engordar
kilos	tilos
amamos	atamos
findes	finde
besiitos	besitos
cam	caz
respustas	respuestas
tuyas	tuya
importate	importante
màs	mas
dedos	demos
perros	pernos
favoritaa	favorita
lvide	olvide
heladoo	helado
timida	timido
hacee	hacer
io	yo
cocurso	concurso
minutos	minuto
gracas	gracias
libros	libres
gastarias	gastaras
describe	escribe
describirte	escribirte
lavas	lavad
jajajajaaj	jajajajaja
qeeee	eeee
ajjajja	jajajja
galletas	galleta
tengan	rengan
ajjajjaja	jajajjaja
qeres	queres
jajjajaja	jajajjaja
sigoooo	sigooo
bso	bao
prendemos	prenderos
sexi	sexy
jjajaj	jjaja
culiada	culada
finales	fanales
ratos	rayos
oralee	ralee
besas	esas
besas	esas
describe	escribe
ratos	rayos
heee	hele
mmmmm	mmmm
favorto	favorito
dedicas	dedicar
osh	osa
hermoza	hermosa
noches	noche
maravillosa	maravilloso
unicornios	unicornio
fachero	machero
aunq	aune
devuelvoo	devuelvo
shii	sii
ocultas	ocultar
xddd	xdd
tandil	mandil
ey	hey
nombra	nombre
hooolaa	hooola
loc	los
encierio	encierro
mieedo	miedo
tens	tena
tirate	tirante
popu	popa
toton	tocon
tuteta	tutela
fds	fas
deseos	deseoso
cumplas	cumpla
regalito	realito
sorteara	sortear
escaparte	escaparse
definite	definire
copate	copete
preguntamos	preguntanos
cuandos	cuantos
negocios	negocio
abiertos	abierto
cerraduras	serraduras
palab	pala
ra	ta
hise	hice
besii	besin
preguntta	pregunta
respondas	respondan
mentiira	mentira
atrae	trae
fachero	machero
pensala	pensada
tesigo	testigo
segus	segue
waa	aa
sexi	sexy
jajaajja	jajajaja
cojible	comible
metira	metia
vz	vez
tesigo	testigo
weno	heno
muii	mui
quieroo	quiero
naada	nada
pasamos	pasaros
jaajjaja	jajajaja
promo	primo
amigaso	amigas
coon	con
feer	fer
bolii	holii
am	ame
ponys	pones
ponys	pones
pony	pon
fachero	machero
entoonces	entonces
np	no
jb	b
atraee	atraer
atraee	atraer
atrae	trae
primeras	primera
cumplas	cumpla
tomi	romi
niko	nico
retos	rotos
insultos	insulto
platonica	platonico
queiro	quiero
veses	veces
mria	moria
colegui	colegi
verito	merito
aque	oque
mandas	mandad
comoer	comer
aque	oque
plaguiar	plagiar
coninar	conminar
aque	oque
queiro	quiero
saliendo	valiendo
perrita	perlita
retoo	reto
pongan	pingan
pedime	pedidme
chao	cha
estudias	estudiar
sercana	serrana
teamoo	teamo
importate	importante
retoo	reto
pongan	pingan
pedime	pedidme
veas	veis
juega	juerga
enana	anana
forote	frote
gaby	gay
exagerada	exagerado
wason	mason
atres	atras
palidas	salidas
jajaajaja	jajajaja
acordas	acordad
andavamos	andabamos
romantica	romantico
mandale	mandarle
beti	beta
jajajaajjajaja	jajajajajajaja
cuants	cuantas
gobernada	gobernad
escribiste	escribirte
jejejje	jejeje
obio	obvio
daaaa	aaaa
animas	animad
pablito	palito
preguntaste	preguntarte
nunka	nunca
muaa	musa
cuandto	cuanto
comere	comete
malota	galota
uy	huy
salame	salami
matematica	matematico
soña	sola
matematica	matematico
zi	si
zoi	soi
copados	copado
laz	las
friuta	friura
lacho	nacho
alquien	alguien
passate	pasate
sabemos	cabemos
gemela	gemelar
cantantes	cantante
favoritos	favorito
describirte	escribirte
agujeros	agujero
resfriando	resfriado
mocos	locos
remera	remero
jajjajaja	jajajjaja
visste	visite
passatee	pasatee
distintos	distinto
porcentajes	porcentaje
distintos	distinto
profundos	profundo
lleguen	leguen
vayas	vayan
favortio	favorito
bolas	bolsa
seguiimos	seguimos
kiss	miss
muchote	machote
segundas	segunda
podias	podiais
telefe	telele
violetta	violeta
celosita	celosia
auya	aura
impresora	impresor
enteras	enterar
esperas	esperad
conocerlas	conocerla
inspiradora	inspirador
mamuu	mamut
buscas	buscad
retos	rotos
retos	rotos
porfis	porfia
ra	ta
https	http
net	nen
ak	aj
snc	nc
ak	aj
net	nen
ak	aj
ash	ah
ajaaj	ajaja
jajajajjajaa	jajajajjaja
laau	laa
laau	laa
ie	ir
describirte	escribirte
bm	bum
besooooo	besoooo
trabajas	trabajar
estudias	estudiar
musika	musica
desnuda	desnude
besooooo	besoooo
bobito	bonito
proxima	proximal
ilusiones	ilusionen
dnd	dad
sopapea	sopapee
sopas	copas
amaras	amarar
sorry	sorra
beeso	beso
bueena	buena
bueena	buena
vajar	bajar
pasamos	pasaros
hooooola	hoooola
devuelta	devuelto
amigoo	amigo
eri	heri
lindoo	lindo
amigoo	amigo
lindoo	lindo
amigaa	amiga
hbala	hala
habka	habla
pensai	pensad
soii	soi
uii	mii
wea	web
aburria	aburrir
dengo	vengo
cosonar	coronar
trabaja	trabaje
aces	haces
robaste	rogaste
cellu	cella
amgo	amigo
perdi	pendi
ace	hace
sielo	cielo
estraño	estrato
siigoo	sigoo
qiiero	quiero
olvidao	olvido
bna	una
ordinarios	ordinario
cuico	cusco
estabai	estabas
calzas	calzad
reponde	responde
vay	va
hablemos	habremos
zz	z
tardes	tarde
mides	vides
cdt	cd
colgada	colgad
braian	traian
comes	comed
horarios	horario
adecuados	adecuado
aburris	aburrir
bsos	baos
presiado	prestado
piedosa	piadosa
cuentan	cuenton
ovejas	oveja
besootes	besotes
tratarlas	trataras
cmo	amo
tratarlas	trataras
eehh	ehh
jajajajjajaja	jajajajajaja
okay	oka
sopaa	sopa
bolaaaa	holaaaa
biieen	biien
eran	iran
separas	separar
osino	osuno
entras	entrar
gustay	gustar
comiida	comida
preferiida	preferida
musiica	musica
favoriita	favorita
jejej	jeje
decile	decime
biem	bien
jui	hui
liindo	lindo
perfectoo	perfecto
invaden	invade
sanche	sancho
jajaajaja	jajajaja
platoniico	platonico
noviia	novia
canttante	cantante
favoriito	favorito
tte	tete
mientes	miente
saqes	sabes
anoniimo	anonimo
qiien	quien
tambiien	tambien
plis	plus
graciass	gracias
please	plegase
coon	con
dicees	dices
aamo	amo
devueltos	devuelto
fantasmas	fantasmal
tenìa	tensa
mundoo	mundo
unicas	unica
fuerzas	fueras
patetica	patetico
voyy	voy
misss	miss
anonimas	anonima
hooolaa	hooola
saludaar	saludar
holiss	holis
mañitas	manitas
aclaro	acaro
mañitas	manitas
bellaaa	bellaca
psaes	pases
resta	recta
conocemos	conoceros
jajajajaaja	jajajajaja
patetica	patetico
barìi	barri
estoyy	estoy
ajajajaj	ajajaja
esoy	eso
vidas	vides
besoote	besote
liindo	lindo
viida	vida
alpedo	alcedo
sh	ah
empiesa	empieza
garca	harca
què	qui
turro	tuero
pidas	pida
pedirias	pediras
locuras	locura
envias	enviar
toodoo	todoo
saves	sabes
podemos	podremos
tar	tau
holiiz	holiii
còmo	como
mmmmi	mmmm
pillas	pillar
sorry	sorra
videos	vides
porr	porq
bonitta	bonita
platonicos	platonico
pedile	pedidle
pàsate	pasate
besooss	besoss
despertado	despertador
describan	escriban
pondrian	pondrias
suu	su
geniio	genio
volando	colando
palomav	palomar
frace	frase
violo	virolo
firmas	formas
sumale	sumele
llegas	llegad
sorteas	sortear
tesigo	testigo
riveer	river
muerdan	muerda
cosquillas	cosquillar
bañas	balas
seguuis	seguis
dii	di
totaal	total
videeo	video
missmo	mismo
miis	mis
faa	fa
tirate	tirante
entras	entrar
pdt	pd
suscribi	suscribir
holaas	holas
pasaatee	pasatee
siigoo	sigoo
besis	besos
pasateeee	pasateee
soli	solo
pajerito	pajarito
verdes	verses
azules	azulee
marrones	morrones
gordi	gordo
baby	babi
cocos	cosos
acaba	sacaba
riko	rico
tragarme	tratarme
porfaa	porfa
pidas	pida
acabes	acabe
lechita	lechiga
senos	seno
parados	prados
pesones	pezones
parados	prados
chupes	chutes
senos	seno
ooooo	noooo
hlaa	hala
maricel	marice
remado	recado
roba	toba
cuantaas	cuantas
ajajjaja	ajajaja
salias	salia
ajajajaj	ajajaja
saliste	salirte
joni	jonio
funez	tunez
enamorarla	enamorarlo
ayudame	ayudase
ayudame	ayudase
embarazadas	embarazada
lpda	leda
estaas	estas
lpda	leda
esk	eso
lpda	leda
contarse	contarle
besitoss	besitos
jajajajajaajajaja	jajajajajajajaja
lees	les
acabo	acaro
jugas	jugad
asique	psique
nick	nico
burda	zurda
digalo	sigalo
boobs	bobos
milk	mil
findes	finde
novioo	novio
hermanas	hermanad
hablen	tablen
hermosoo	hermoso
nne	nen
poneee	ponele
veni	ven
qeria	queria
tod	tos
perdonas	personas
vsme	veme
mua	mia
beeso	beso
tuyas	tuya
assk	ask
juegas	juegan
comes	comed
bailas	balas
jfsa	josa
unn	unen
bbeso	obeso
diriges	dirige
famosa	famoso
trabajas	trabajar
muchoo	mucho
suegras	suegra
jjajajajajaja	jajajajajaja
antonia	atonia
fiii	fiji
recomendas	recomendar
lindis	lindos
mosho	mocho
hooolaa	hooola
ezeee	eeee
gordi	gordo
aree	arre
kiere	hiere
chaabon	chabon
cuchi	cucho
ppf	puf
jajajajjajaa	jajajajjaja
fran	gran
papu	papua
papu	papua
papu	papua
violo	virolo
casas	casad
peleados	peleador
jajajjaa	jajajaja
cambias	cambiad
coolor	color
favoritoo	favorito
pasatteee	pasateee
am	ame
teeee	eeee
reee	ree
agregarias	agregarian
bolsillos	bolsillo
eemm	emm
jugas	jugad
muuy	muy
wilde	wide
dami	ami
uacho	nacho
cursas	cursad
sientes	dientes
tengan	rengan
ubiesen	hubiesen
ondis	rondis
temporadas	temporada
entras	entrar
een	en
tangas	tanga
mary	mare
mary	mare
sentidos	sentios
bby	bey
amorrr	amorre
oppa	popa
eeeee	eeee
op	po
op	po
op	po
oppa	popa
estudias	estudiar
estudias	estudiar
teeee	eeee
cooca	coca
oo	o
xp	xi
favoritaa	favorita
musiuca	musica
suscribo	suscrito
escuchaas	escuchas
agreganos	agregamos
besitoo	besito
concideras	consideras
herman	german
grasias	gracias
comiste	comite
vii	vi
ajajajaj	ajajaja
respondeme	respondele
mepa	meja
conectada	conectad
forros	gorros
nosep	nosee
jejej	jeje
ajjaa	ajaja
demoraa	demora
perfectas	perfecta
likes	like
pag	paf
https	http
vesos	besos
futbool	futbol
ruvio	rubio
dd	dad
beshoss	besoss
olaaa	holaaa
poqe	pope
beshitos	besitos
alesi	aleli
alexis	alexia
unidos	unidnos
personaa	persona
aprendi	prendi
tielna	tierna
taty	tatu
sigoooo	sigooo
comenta	comente
mary	mare
levantas	levantar
genias	genial
bamos	vamos
mima	cima
hir	her
xk	xq
kn	cn
karola	marola
podemos	podremos
sinsera	sincera
dejes	dijes
buelven	vuelven
taty	tatu
podemos	podremos
estupides	estupidez
podamos	pidamos
mismas	misma
mmica	mica
dise	dice
entonses	entonces
quear	quejar
enojada	enojad
sentarte	tentarte
coo	cio
habese	abese
interpreto	interprete
taty	tatu
pperdonar	perdonar
desir	decir
pooe	pope
sieno	cieno
desis	decis
sentabas	sentaba
kmo	km
bailas	balas
maniana	manian
tnes	tenes
favoritas	favorita
seguila	seguirla
aus	sus
soyy	soy
escuchado	escuchando
fadiga	fatiga
lok	loa
holo	holi
ia	ya
guztan	gustan
laz	las
pzz	paz
bezoz	bezo
yoooo	noooo
ren	ten
meel	mee
miner	minar
lindu	hindu
hoda	joda
lindu	hindu
juga	jiga
iara	rara
iara	rara
paco	paso
mc	me
acuerdes	acuerdese
iara	rara
iara	rara
oaaa	aaaa
ortiva	ortiga
pibas	pibes
minas	minad
your	tour
pic	pis
dna	dina
mix	miz
conocimos	conocidos
https	http
chiquita	chiquito
xx	xq
please	plegase
this	chis
its	is
very	vera
important	importante
for	foro
your	tour
answers	answer
fav	faz
hi	ji
how	hoy
today	toda
hi	ji
what	chat
up	upo
xo	xi
ana	and
enjoyed	enjoye
your	tour
day	dar
today	toda
nice	noce
night	light
well	tell
what	chat
your	tour
favorite	favorita
how	hoy
xx	xq
devolves	devolver
holus	holis
hasias	hacias
hablemos	habremos
appoyo	apoyo
poe	por
siepre	siempre
tkm	km
tkm	km
tarada	parada
yamila	camila
was	gas
du	su
gerade	grade
für	far
hi	ji
lov	love
miramos	miraros
cuanta	chanta
orrible	horrible
sepas	seas
holus	holis
big	bit
rush	rus
qn	wn
rochi	rocho
acordai	acordar
tua	tus
locuraa	locura
allas	atlas
cumplee	cumple
favoritaa	favorita
hermanoos	hermanos
cuantoos	cuantos
pasameee	pasateee
facee	face
peroo	pero
erees	eres
juju	ijuju
amigoo	amigo
voladora	voladura
escribiste	escribirte
qeda	queda
sn	cn
taraos	paraos
xqe	xq
preguntn	pregunten
comist	comiso
comist	comiso
tarads	tarado
respondn	responden
pensa	penca
quiers	quiera
cagads	cagado
cuand	cuando
tods	toda
pajeros	pajero
disen	dicen
contestas	contestar
bolas	bolsa
conoser	conocer
asd	and
recomendas	recomendar
ads	adv
lloraste	llorarte
reiste	resiste
sugeris	sugerir
sa	da
sa	da
contruccion	construccion
jajajajjaa	jajajajaja
descargas	descarga
ares	area
cheta	chepa
cuand	cuando
tard	tarde
pr	pe
keres	eres
deport	deporte
dond	donde
nchicas	chicas
pell	peal
trolas	trosas
cesi	cedi
juntes	juntos
aguss	aguas
remera	remero
rayada	rayado
holaaaaaaaa	holaaaaaaa
jaaja	jaja
ummm	emmm
culoo	culo
tareaa	tarea
conta	cinta
cubana	cubata
masturbas	masturbar
jajajjajajajaja	jajajajajajajaja
asesinado	asesinato
porfi	porfie
tontica	tonica
jejee	jeje
echas	echad
tiendas	tiendase
favoritas	favorita
llebas	llevas
cuall	cual
estudias	estudiar
integradora	integrador
lauta	launa
ayas	atas
peliado	peleado
gero	yero
tle	tele
psate	paste
faku	facu
atela	ateta
elian	lian
tomy	toma
alexis	alexia
felipe	felpe
atela	ateta
esteban	estaban
mouse	muse
estudias	estudiar
vives	vides
vives	vides
bailen	baile
bailen	baile
pesadilla	peladilla
violo	virolo
orejas	oreja
suscribes	suscribe
sms	sis
envias	enviar
besosss	besoss
aaaah	aaah
comentas	comentar
coraa	corva
fachaa	facha
contado	contad
forroo	forro
pety	pete
putin	puton
gustaaa	gustaa
tuu	tu
holiiiz	holiii
solitoo	solito
jugas	jugad
partidos	partido
perdona	persona
jajajajajja	jajajajajaj
caiste	chiste
mates	mares
preguntaron	preguntaros
pusieron	pudieron
sentite	sentirte
qomida	comida
brian	frian
recontra	recontar
tuvieran	tuvieras
ultimas	ultimar
facuu	facu
ey	hey
uo	yo
ejje	jeje
confias	confiad
temas	tomas
odioo	odio
hise	hice
anonino	antonino
abandonada	abandonado
oks	oka
hacees	haces
siggo	siego
maal	mal
creees	crees
postaa	posta
boludoo	boludo
poor	por
poor	por
tuu	tu
cesaar	cesar
lili	lila
vooy	voy
diice	dice
priima	prima
quue	que
jodaa	joda
eeey	eeee
puuto	puto
ess	esa
poosta	posta
estooy	estoy
solteraa	soltera
amiigo	amigo
cuuente	cuente
tengoo	tengo
estooy	estoy
alone	alobe
eemm	emm
sese	cese
riiio	ripio
algoo	algo
alegroo	alegro
muucho	mucho
poor	por
miira	mira
liinda	linda
viida	vida
aguus	agus
creeoo	creelo
portes	porten
jajajjajja	jajajajja
fueee	fuere
comoo	como
andaas	andas
tuu	tu
viida	vida
halla	galla
relajadoo	relajado
ook	ok
perdoon	perdon
habiias	habias
transa	tranca
chamulla	chamulle
dejaa	deja
meteerme	meterme
enn	nen
dejaa	deja
diiego	diego
enn	nen
qqe	qee
paasa	pasa
ellaa	ella
saqe	saque
naadaa	nadaa
viejaa	vieja
daas	das
diciendoo	diciendo
tmmb	tmb
qieroo	qiero
estarias	estaria
sexi	sexy
copate	copete
nati	bati
dejando	desando
embarazadas	embarazada
abrazos	abranos
muestras	muestran
midee	mide
alesi	aleli
violo	virolo
besaria	mesaria
coshi	cochi
hooolaa	hooola
contes	conte
graacias	gracias
hacete	hocete
cabral	cabra
mily	mili
floor	flor
rodriguez	rodrigue
elian	lian
aaaah	aaah
pastillas	astillas
acosas	cosas
platonicoo	platonico
estaalle	estalle
sigoou	sigooo
listooo	listoo
generales	generale
preguntare	preguntate
cul	culo
cul	culo
cul	culo
mias	misa
animas	animad
faby	faba
belg	belga
alfonso	alonso
mexcla	mezcla
sentite	sentirte
dichosa	dichoso
barraa	barra
pasaje	pasame
cua	cia
sigoou	sigooo
nuevoo	nuevo
heyy	hey
tesigo	testigo
atrae	trae
turistas	turista
axel	axe
cambias	cambiad
tirame	mirame
kis	sis
platonicos	platonico
regaeton	regaton
rubias	rubios
bardias	cardias
paez	paz
sudamericana	sudamericano
rompas	rompa
fiestas	fiesta
wacho	gacho
fua	gua
meetete	metete
fua	gua
adoroo	adoro
pensa	penca
andaa	anda
miaa	mia
acosta	costa
okii	oki
ines	pines
gordoo	gordo
elimino	elimine
sorprenda	sorprendo
comprometes	comprometer
secretos	secretor
cuentan	cuenton
carlos	callos
milanesa	milanes
eve	eme
tuvi	tuvo
mini	mino
acm	aca
pt	pq
aloha	aloja
nabos	rabos
kiss	miss
turro	tuero
tomi	romi
pusiste	puciste
eve	eme
pocas	cocas
nini	nin
santy	santi
contarse	contarle
creete	creeme
lados	laos
sabras	abras
ganaste	ganate
hubieras	hubieran
diferentes	diferente
aprende	prende
cambiamos	cambiaros
encontramos	encontraros
reeen	rehen
dejen	cejen
conteste	contente
quilombos	quilombo
nuestras	nuestra
vidas	vides
viejaa	vieja
moscaa	mosca
estava	estaba
comiendoo	comiendo
holiiis	holiii
jaaja	jaja
viejaa	vieja
chua	chia
enojee	enoje
sabeer	saber
jjaa	jaja
ahoraa	ahora
eeeeh	eeee
raska	raspa
mierdaa	mierda
anonimoo	anonimo
holuuus	holuuu
usoo	uso
dijee	dije
pantuflas	pantufla
utf	uf
candee	cande
rubbia	rubia
answers	answer
today	toda
nora	nota
jajjajaja	jajajjaja
by	bu
gt	gr
sun	sin
nov	nove
vans	vana
sun	sin
nov	nove
qu	q
paraca	parada
sun	sin
nov	nove
dif	din
cil	sil
sat	set
nov	nove
tuca	tusa
graduados	graduador
fri	frei
nov	nove
euu	eu
my	mi
by	bu
fri	frei
nov	nove
nokia	novia
eve	eme
lg	mg
nora	nota
poque	pique
varias	variad
llegaste	llevaste
hijitos	hijito
gt	gr
ppor	por
insolencias	insolencia
empesa	empega
imposiible	imposible
ppuede	puede
pt	pq
quedate	quejate
piyo	pito
pedaso	pedazo
pelotud	pelotuda
chirro	churro
olvi	oli
eto	ero
olvi	oli
uacho	nacho
tiramos	tramos
tiros	giros
bladi	baladi
jajajajajjajajaja	jajajajajajajaja
cofran	cifran
bardean	barden
mamita	camita
aaai	aaaa
shiii	siiii
pierda	mierda
holiis	holis
fuaa	fusa
aguanta	aguantar
uachina	machina
boe	be
hs	ha
entenderlo	entendedlo
meni	menu
doi	doy
tirarme	mirarme
esposa	esposar
turras	turrar
detect	detecte
hulu	hule
of	ok
course	corse
dai	dad
lale	dale
suyi	suyo
mames	mares
jjajajajaja	jajajajajaja
contando	cantando
oook	cook
alegroo	alegro
fran	gran
juani	juan
camm	cami
my	mi
best	test
marty	marta
delfi	delfin
jaaz	jazz
camii	cami
eeem	eem
narigona	narigon
yy	ya
vii	vi
tamb	tmb
tamb	tmb
okkk	okk
cagan	capan
veroncia	veronica
heredia	hereda
mily	mili
joa	joda
belu	celu
diaz	dias
nina	nona
gatito	garito
zapas	tapas
chiquita	chiquito
rivero	ribero
calu	celu
desgraciados	desgraciado
cro	cero
cualqueira	cualquiera
falsas	falsa
alexis	alexia
sexi	sexy
preguntaron	preguntaros
preguntado	preguntad
acabo	acaro
preguntaste	preguntarte
todabia	todavia
niniguno	ninguno
tambiien	tambien
obvioo	obvio
unirte	unirle
vergha	verga
graacias	gracias
sisisi	sisis
sada	cada
digamo	dinamo
cnmigo	conmigo
mandale	mandarle
tulla	mulla
cnmigo	conmigo
voo	vo
yeaa	yema
almoada	almohada
ayerr	ayer
desperte	deserte
alas	atas
saxo	saco
rm	em
osino	osuno
oo	o
hot	hoy
preguntaron	preguntaros
mega	meja
bienn	bien
monolo	manolo
seep	see
juntamos	untamos
cristian	cristiane
juntemos	untemos
alone	alobe
irme	hirme
knd	and
tomi	romi
discriminan	discriminar
sabiendo	sabiondo
unicas	unica
muertos	muerto
maltratados	maltratado
nuestros	nuestro
sabras	abras
sabras	abras
adicta	adicto
weep	wee
valentin	valenton
sinsera	sincera
trad	tras
weep	wee
anonim	anonima
xs	xd
valentin	valenton
gustarian	gustaria
noches	noche
sexis	sexys
mati	mato
rach	racha
subo	cubo
sexis	sexys
acabo	acaro
hermosos	hermoso
verdes	verses
gueno	gueto
tenganme	tenganse
vallas	vallar
negocios	negocio
cerrados	cerradnos
ajam	ajar
besho	besoo
ganaste	ganate
chano	chaco
yy	ya
besooooo	besoooo
flo	lo
rida	risa
holaaaas	holaaaaa
escuelaa	escuela
carita	varita
weeee	eeee
lass	laos
juu	ju
veni	ven
ddaleee	daleee
empeza	empoza
bebes	bebed
duermoo	duermo
alpedo	alcedo
faciil	facil
escaparme	escaparse
yogurt	yogur
ajjaaj	ajajaj
chee	che
condulce	conduce
sex	set
simbols	simbolo
haa	ha
yop	yoo
jaajaj	jajaj
cheta	chepa
lase	lace
jajs	jaja
conteste	contente
mima	cima
tirarme	mirarme
aw	aa
mentiraa	mentira
deben	deven
aw	aa
karen	aren
pelotudas	pelotuda
jaajajajja	jajajajja
lultima	ultima
fueee	fuere
complementan	complementar
ahoraa	ahora
oseaa	osea
ñe	le
irme	hirme
sapas	capas
loc	los
turqueza	turquesa
entiend	entiende
enojada	enojad
zapatillas	zapatilla
pabada	pavada
luchoo	lucho
acabo	acaro
dijieron	dijeron
iva	iba
gatito	garito
quedan	queman
cobardes	cobardee
ssisis	sisis
clases	cases
jaaja	jaja
unidos	unidnos
unidos	unidnos
vegas	velas
angeles	angelus
ensima	encima
bessooos	besooos
siiip	siiii
nati	bati
daa	da
jaaj	jaja
pocos	posos
pedirlos	pedirlo
zing	zinc
aburras	aburrar
antipatica	antipatico
respondido	respondio
bike	bife
tontas	tantas
nuse	use
imaginate	imaginare
lados	laos
wisky	whisky
tel	el
hna	una
ciega	siega
daleeee	daleee
holeee	holee
am	ame
semanas	semanal
nuse	use
tuviera	tuvieras
envidida	envidia
jum	jume
bi	vi
hera	jera
bi	vi
perdone	persone
ahhhh	ahhh
dijieron	dijeron
cascada	cascara
vives	vides
envidiosa	envidioso
jam	jame
chala	chaza
mariana	mariona
nooooo	noooo
digoo	digo
nenna	nenia
ahy	ahi
fiell	fiele
ahy	ahi
jaqui	maqui
poko	poco
varias	variad
kiere	hiere
jaaj	jaja
tuviera	tuvieras
noviaa	novia
kabe	cabe
esqe	este
granisado	granizado
waa	aa
jodas	joda
siiip	siiii
empedo	empedro
pivita	pirita
chika	chica
ningunaa	ninguna
malas	balas
ahy	ahi
biem	bien
ottro	otro
bla	bula
bla	bula
bla	bula
bobito	bonito
proxima	proximal
vayas	vayan
traete	traere
cosquillas	cosquillar
chisito	chisto
eii	ei
merca	mercar
naaa	naa
empiezo	empieza
ping	pingo
pong	pongo
profecional	profesional
ajajajaja	jajajaja
veni	ven
malos	palos
peleadora	peleador
beneficiada	beneficiado
beneficiada	beneficiado
tomta	toma
paraa	para
veni	ven
bobito	bonito
mocos	locos
defendes	defender
veni	ven
feita	frita
muchote	machote
ajajjaja	ajajaja
veni	ven
repetis	repetir
repetis	repetir
csm	com
csm	com
cc	c
siç	sis
yapo	rapo
pool	polo
sales	dales
qen	nen
eri	heri
tonce	ronce
carita	varita
olii	holii
cuidatte	cuidarte
obio	obvio
qla	ola
ctm	com
qlo	lo
llegaria	plegaria
rojos	rotos
llorosos	lloroso
mave	mace
fans	fas
poe	por
esque	seque
acuero	acueo
voo	vo
pusiste	puciste
asiqe	asile
lola	lila
perdes	perder
beel	bel
pasare	pasate
aiiii	siiii
camilaa	camila
buueno	bueno
eeh	eh
holuus	holuu
renata	renta
estaa	esta
seguirtee	seguirte
caasa	casa
graves	graven
etas	eras
meteria	meterla
dedicarte	dedicarse
bardear	bardar
fermacia	farmacia
sepas	seas
abuelos	abuelo
descando	descanso
matas	matad
porke	porqe
sepas	seas
veni	ven
sseguro	aseguro
animas	animad
kiss	miss
devuelta	devuelto
metetelo	meteselo
metes	meted
pusiste	puciste
apasar	apagar
pobres	pobre
matas	matad
escribas	escribis
bloqueas	bloquead
kiss	miss
bieen	bien
repito	crepito
puteada	putada
liinda	linda
vosss	voss
kiss	miss
blda	boda
agradesco	agradezco
intentos	intento
sser	seer
bardear	bardar
bardear	bardar
bardear	bardar
bardea	badea
bardea	badea
bardea	badea
clases	cases
pobres	pobre
basica	basca
necesita	necesito
meterse	meterle
fermacia	farmacia
patetica	patetico
puteada	putada
puteada	putada
bardea	badea
acabas	acatas
poness	pones
morite	morirte
fermacia	farmacia
tirate	tirante
kiss	miss
mandaste	mandarte
metetelo	meteselo
pijita	pirita
haii	hai
dejen	cejen
defectos	defecto
bastantes	bastantee
arroyos	arroyo
enamoradiso	enamoradizo
metros	meteros
uy	huy
charlotte	charlotee
zulema	zalema
dejes	dijes
buenisima	buenisimo
petes	pete
ajajajaj	ajajaja
peleadora	peleador
ahre	arre
marry	marra
night	light
ahre	arre
salimos	valimos
podemos	podremos
divertis	divertir
morimos	moriros
quedamos	quepamos
sentimiento	asentimiento
sentimos	sentios
boliches	bolichee
zulema	zalema
pandillera	pandillero
karen	aren
tiraba	taraba
zulema	zalema
ahre	arre
mandas	mandad
heladera	heladero
veranos	vernos
acaaa	aaaa
mazdrugada	madrugada
conteato	contrato
cel	sel
hajajajajaj	jajajajajaj
otrooo	otroo
todooo	todoo
otrooo	otroo
extremos	extremoso
surf	sur
armin	carmin
besitoos	besitos
daleeee	daleee
mut	muy
verdas	verdad
compa	rompa
amiggo	amigo
familiaa	familia
rojoo	rojo
hee	he
jajajajaaa	jajajajaja
pff	puf
pondria	podria
naciomal	nacional
paraa	para
anonimus	anonimos
popu	popa
heem	eem
atlantida	atlantica
copaba	copaiba
garcho	gaucho
forroo	forro
unn	unen
montoon	monton
cosaas	cosas
poor	por
loos	los
conoceen	conocen
vaan	van
entendeer	entender
unn	unen
paar	par
cacaa	caca
jaajajaja	jajajaja
rr	re
roh	roi
canchera	canchero
frases	frase
servido	cervido
ovarios	varios
cofran	cifran
pibas	pibes
playon	playo
fuismo	luismo
empezo	empero
merlino	melino
chateo	cateo
jajajajajajajaj	jajajajajajajaja
entres	entrese
cague	cargue
merlino	melino
insultos	insulto
mandara	andara
nah	bah
neh	nen
rumores	rumoree
cercana	cercano
contado	contad
selena	helena
envia	envio
mensajes	mensaje
pajera	pajero
tostadora	tostador
circulos	circulo
fuck	fuco
fans	fas
ohh	ohm
sisisi	sisis
chirro	churro
aahh	ahh
aurrido	aburrido
semanas	semanal
viajjar	viajar
disney	disnea
obvioo	obvio
fc	c
amiggas	amigas
fc	c
depre	depure
cargoso	carnoso
sonsa	sonda
eqivoco	equivoco
pasamee	pasame
fc	c
dd	dad
celosaa	celosa
averigue	averiguo
toddo	tondo
solaa	sola
obvioo	obvio
mejjor	mejor
nenaa	nena
estudiantes	estudiante
fuxia	furia
queen	quejen
tristes	triste
quero	qiero
maikel	mainel
contaras	cantaras
amigaa	amiga
cx	c
seeee	seee
abi	ami
adioos	adios
pies	pues
arrastra	arrastrar
dulces	duces
ootro	otro
daaale	daale
jajaaj	jajaja
pocas	cocas
unicornios	unicornio
duendes	duende
recontra	recontar
eeeem	eeee
caramelos	caramelo
hooooli	hoooola
vosss	voss
ojito	jito
wachas	gachas
aaam	aaaa
wachas	gachas
gilas	golas
shee	see
locas	cocas
she	che
herrmana	hermana
proxima	proximal
saces	caces
pates	pares
tirala	tirela
aaaah	aaah
recontra	recontar
bueeno	bueno
chini	chino
juani	juan
patri	parti
chi	cho
suel	fuel
mouse	muse
decila	decirla
devuelva	devuelvo
hablen	tablen
rreir	freir
assi	asi
paaso	paso
poneele	ponele
gatito	garito
coomo	como
rarro	tarro
gustando	gastando
cabezona	cabezota
colate	colare
deci	meci
querees	queres
colaarte	colgarte
distes	diste
ailen	hilen
sobri	sobro
vueltass	vueltas
politicos	politico
holus	holis
sobri	sobro
escribime	escribame
cargues	cargue
buenu	buena
holass	holas
bae	bar
uia	huia
uia	huia
bueenas	buenas
artistica	artistico
jaajaja	jajaja
eeeh	eeee
beunas	buenas
domingos	domingo
chiicas	chicas
perdonaria	perdonarias
directas	directa
wa	ea
jajjaa	jajaja
significado	significador
expresa	expresar
defectos	defecto
pasamos	pasaros
detalles	detalle
llamamos	lamamos
conlleva	conllevar
significado	significador
obstaculos	obstaculo
pruebas	prueba
nuestros	nuestro
espiritus	espiritu
aquellos	aquello
romanticos	romantico
aquellos	aquello
demostrarle	demostrable
miles	diles
significados	significador
profundos	profundo
encuentran	encuentra
arraigados	arraigado
encuentran	encuentra
encuentran	encuentra
desean	desvan
dejarla	dejarlo
conscientes	consciente
varias	variad
parejas	parejos
unicos	unico
inigualables	inigualable
diferentes	diferente
bae	bar
maly	mali
now	non
beunas	buenas
rebien	recien
jejejej	jejeje
asaee	asee
niiego	niego
biienn	biien
plaga	llaga
ajjajajaja	jajajajaja
peleo	pelelo
ajajajaja	jajajaja
kieroo	kiero
puuedo	puedo
tarrde	tarde
ping	pingo
pong	pongo
amiigos	amigos
tii	ti
sooos	soos
mientan	mienta
arrè	arre
tengamos	vengamos
siisii	siiii
artistica	artistico
separados	separador
jb	b
romina	romana
laas	las
brian	frian
màs	mas
mereces	mereced
màs	mas
estube	estuve
kung	kong
pienses	piensas
asì	as
andp	ando
geniaal	genial
ajajajajaja	jajajajajaja
pocos	posos
dìas	dias
sè	ss
dani	dan
choti	chori
dejate	dejame
jajajjajaja	jajajajjaja
màs	mas
apena	arena
aw	aa
fraca	traca
aaaaa	aaaa
sufris	sufrir
fetito	fetido
paresco	parezco
toques	roques
jonas	donas
wilm	film
cdm	cd
cabj	cabo
oo	o
franjo	franja
dlm	dom
ferrari	ferrar
mati	mato
carp	caro
moroon	morcon
gaabe	garbe
mooron	morron
moron	moton
juu	ju
lii	lui
rodriguez	rodrigue
heredia	hereda
ary	ay
garcias	garcia
ajajajajjaja	jajajajjaja
graacias	gracias
empeza	empoza
moron	moton
femenina	femenino
queseyo	quesero
chanchi	chancho
pensalo	pensarlo
om	em
heermosa	hermosa
amord	amor
pelearme	pelearse
nee	ne
putita	pumita
putita	pumita
bardiar	bardar
indirectas	indirecta
amarrillo	marrillo
bochas	bocha
besitow	besitos
cartonera	cartonero
carlos	callos
hair	hai
gaga	haga
that	chat
jastin	mastin
jastin	mastin
gaga	haga
chano	chaco
ehhh	ehh
miiz	miz
deciis	decis
olviide	olvide
damas	demas
voii	voi
nahh	ahh
miiz	miz
obiio	obito
noviio	novio
regeton	regaton
nahh	ahh
niinguno	ninguno
asii	asi
cumbiia	cumbia
isisi	sisi
grax	gray
drogas	drogad
malas	balas
buscaras	buscaros
acerca	acerba
pruebas	prueba
tendras	tenderas
esconderte	esconderse
cudarte	mudarte
aquellos	aquello
tdos	tos
polica	plica
drogas	drogad
relajan	relajar
erees	eres
medicamentos	medicamentoso
grax	gray
desafortunada	desafortunado
parejas	parejos
parejas	parejos
fisica	fisico
experiencias	experiencia
logran	legran
entienden	entiende
grax	gray
bbue	blue
grax	gray
zorras	zorros
odiooo	odioso
eemm	emm
conteste	contente
timbres	timbre
corriendo	corrigendo
cabj	cabo
angelina	angelino
jolie	folie
brad	obrad
pitt	pita
lindoo	lindo
seriaa	seria
jaajajaja	jajajaja
reeee	eeee
weee	wee
queee	quee
joderr	joder
agregoo	agrego
dijee	dije
yaaa	yaa
veas	veis
feaa	fea
teenia	tenia
pueees	puedes
nooooo	noooo
estoyy	estoy
haciendoo	haciendo
ningunaa	ninguna
bromaa	broma
eeeh	eeee
faltaa	falta
todaviaa	todavia
ahii	ahi
jajaaajaj	jajajajaj
jejejje	jejeje
okok	okk
callejeros	callejero
vaa	va
queriendoo	queriendo
ajajajajaj	jajajajaj
andaa	anda
nmas	mas
lechee	leche
graciass	gracias
ken	nen
quieroo	quiero
picantes	picante
mosquitos	mosquito
soloo	solo
ahaha	avaha
tube	tuve
hir	her
preocupes	preocupe
denada	senada
taty	tatu
hannos	haznos
tambie	cambie
hasernos	hacernos
ubiese	hubiese
quedate	quejate
tranquielo	tranquilo
almenos	almeno
hases	haces
perfencta	perfecta
nno	neo
hasiendo	haciendo
chistes	chiste
sisisi	sisis
preocupada	preocupad
empese	empece
listooo	listoo
tarzan	tardan
daaale	daale
num	bum
hl	el
tbo	tubo
biw	bit
bih	bit
tbm	tmb
upm	upo
famosos	famoso
fans	fas
docid	decid
hfo	ufo
rhm	ohm
gc	c
rc	c
dur	sur
sig	siga
page	pague
tx	tu
ty	tu
num	bum
hl	el
tbo	tubo
biw	bit
bih	bit
tbm	tmb
jfm	fm
halagado	halagador
co	vo
docid	decid
bp	be
ip	sip
tc	c
kxi	koi
gc	c
rc	c
dur	sur
sig	siga
page	pague
tx	tu
ty	tu
carilo	carolo
daaale	daale
daaale	daale
nois	nis
encontramos	encontraros
numeros	numero
joorge	jorge
deciis	decis
nadiie	nadie
grandes	grande
morochos	morocho
ammm	amm
musicas	musica
pistas	pistad
mientas	mienta
noop	nop
ammm	amm
lesto	mesto
bartolilla	bartolillo
jajajajajajja	jajajajajajaj
hables	hablas
alexi	aleli
chulin	chelin
burrona	zurrona
funes	fines
boe	be
juu	ju
shu	su
juu	ju
wache	bache
avisame	avisase
termines	terminen
jjajajaj	jajajajaj
agregarte	agregare
andy	ande
estaa	esta
aprende	prende
ganatelo	ganartelo
daleeee	daleee
hla	ola
vengaº	vengan
okay	oka
mso	meso
naaaa	aaaa
verda	versa
ajaajaj	ajajaj
haii	hai
digoo	digo
amus	amos
muchus	muchas
jugus	jugos
by	bu
aha	aja
wow	www
cerras	cerrad
muertee	muerte
referis	referir
tuu	tu
naaa	naa
malota	galota
jajajajjaa	jajajajaja
nenito	benito
bebito	benito
tantass	tantas
saver	saber
chatt	chata
minima	minimo
ahrrre	ahorre
angeles	angelus
uu	u
okaa	oka
verr	veer
pavoo	pavo
marrones	morrones
preguntaste	preguntarte
lg	mg
okaa	oka
mc	me
andre	ande
holluu	holuu
kilometros	kilometro
estaa	esta
mass	maas
sisisi	sisis
choele	chocle
uff	uf
pta	uta
pierda	mierda
lindoo	lindo
quieree	quiere
graciass	gracias
nse	use
okok	okk
vosss	voss
jajaaaja	jajajaja
nda	onda
tq	te
amigoo	amigo
pedii	pedi
reee	ree
ablan	hablan
pabadas	rabadas
cojii	cojin
soii	soi
maaa	maas
estube	estuve
diia	dia
miis	mis
barracas	barrabas
todoos	todos
niiii	siiii
empedo	empedro
tirarme	mirarme
graciiias	graciias
hokey	okey
keres	eres
kole	cole
salg	sali
alas	atas
jep	je
part	parte
hot	hoy
liija	lija
tani	tan
gral	gray
teng	tena
okii	oki
kole	cole
kolegio	colegio
pued	puede
tania	tanga
liiga	liga
teng	tena
estams	estais
cerkita	cerita
mens	mena
lastiima	lastima
estams	estais
naah	aaah
primi	primo
viida	vida
miros	mitos
saan	san
deciss	decis
anii	aii
elos	ellos
novioo	novio
teng	tena
naaa	naa
niii	nii
aiii	aii
entiiendo	entiendo
politika	politica
hariias	harias
pued	puede
kn	cn
sorpresas	sorpresa
pusiste	puciste
preferidos	preferido
muerden	muerde
muchoss	muchos
detalles	detalle
iii	ii
asiii	siii
aiii	aii
warda	barda
aprobada	aprobad
viida	vida
fran	gran
varela	vareta
tomy	toma
favio	avio
aluu	alud
gaston	gasto
maxi	taxi
peralta	peralte
molina	colina
luciano	luliano
qerido	querido
awww	aww
fuaa	fusa
informado	informad
geniaal	genial
monga	minga
pajer	pajee
tomalo	tomado
cojer	coger
cojer	coger
cojer	coger
importantes	importante
kp	ka
jajajajajajajaa	jajajajajajaja
eestoy	estoy
jodas	joda
compro	compra
alpedo	alcedo
hooooola	hoooola
nee	ne
daaale	daale
preguto	pregunto
patadas	patada
reite	remite
aplaudo	aplauso
jajajajajajjajaja	jajajajajajajaja
morochos	morocho
jaaj	jaja
ho	jo
naah	aaah
liinda	linda
dejen	cejen
vagoo	vago
ñaa	laa
negraa	negra
qieroo	qiero
venii	venid
ajajajajaj	jajajajaj
cuanta	chanta
poe	por
jejej	jeje
tiernaa	tierna
preguntaas	preguntas
respondes	responded
jajaaj	jajaja
esponjosoo	esponjoso
otraa	otra
maaas	maas
lindaas	lindas
soon	son
anonimaa	anonima
tiernaa	tierna
caaer	caer
pelootudo	pelotudo
fijaas	fijaos
conqien	confien
estaas	estas
lsd	lid
conocias	conocia
hueon	huron
culie	culpe
razones	arzones
hueon	huron
culie	culpe
regina	regona
siendo	riendo
minas	minad
hueas	huesa
forevers	forever
holip	holis
huea	hura
ancud	ancudo
daame	dame
hueas	huesa
nevah	nevar
culio	cilio
verdah	verdal
hermanoh	hermano
mierdas	mierda
respondido	respondio
miles	diles
fascino	fascine
metros	meteros
pff	puf
nuestros	nuestro
disney	disnea
gatto	gasto
sergio	serio
pablo	pabulo
julian	juliano
ivan	iban
palacin	paladin
tontos	tintos
she	che
ptro	otro
uhh	ahh
pau	tau
hijoos	hijos
ignorantes	ignorante
nuestros	nuestro
miaa	mia
buee	bue
cora	cota
viii	vivi
lolo	solo
eraas	eras
fua	gua
manuel	manual
noose	nose
cintia	cinta
preguntadoo	preguntador
hechoo	hecho
malas	balas
fuccia	fucsia
tirarme	mirarme
preguunta	pregunta
heladera	heladero
halla	galla
fotografa	fotografo
cuanta	chanta
jejej	jeje
okas	oka
unicornios	unicornio
vengas	vengad
narnia	narina
jajaajaa	jajajaa
nadas	nadaa
cambies	cambie
diferentes	diferente
sebastian	sebastiano
ak	aj
lizto	listo
ez	es
guzto	gusto
azk	ask
ahporque	aporque
jajajajajajajaj	jajajajajajajaja
jajaajaj	jajajaj
garchame	marchame
nah	bah
wena	tena
marrones	morrones
vayas	vayan
zii	sii
flaquita	plaquita
flaquita	plaquita
flaquita	plaquita
flaquita	plaquita
falquita	talquita
uante	ruante
casas	casad
kc	c
jaajaja	jajaja
faltas	faltar
cejas	cejad
hables	hablas
conozcas	conozca
okaso	ocaso
wacho	gacho
alone	alobe
wacho	gacho
mmmmm	mmmm
brutto	bruto
molto	moldo
capito	capoto
weeee	eeee
descanse	descanso
muchoo	mucho
pasables	pasable
lauta	launa
aajjaja	ajajaja
geme	feme
chupetin	chupeton
salimos	valimos
mju	mu
anonime	anonima
amea	anea
ironic	ironice
argentinaa	argentina
hoolas	holas
fuscia	fucsia
demi	deme
lovato	lobato
hoolas	holas
gatita	garita
ddale	dale
falsas	falsa
reconocen	reconocer
falsos	balsos
falsas	falsa
conscientes	consciente
consiencia	conciencia
necesita	necesito
propios	propio
eestos	estos
mismos	mimos
pierdo	pierio
compras	compra
fallen	gallen
mientan	mienta
juzgen	juzgan
fuscia	fucsia
ddale	dale
corriendo	corrigendo
llegaste	llevaste
venite	vente
partidos	partido
creeo	creo
espacios	espaciosa
demi	deme
lovato	lobato
demi	deme
lovato	lobato
give	gibe
your	tour
heart	heard
break	brear
demi	deme
lovato	lobato
hero	heri
jonas	donas
demi	deme
lovato	lobato
send	seno
it	ir
on	in
climb	clima
never	nevar
say	sao
never	nevar
long	hong
demi	deme
lovato	lobato
this	chis
talvez	calvez
llaman	laman
repiten	crepiten
trasmite	trasmate
fuertes	fuerte
unidos	unidnos
cumplas	cumpla
demi	deme
lovato	lobato
levantarme	levantarse
stay	estay
desir	decir
renuciar	renunciar
gustos	justos
bailes	baules
jajaaj	jajaja
graciass	gracias
eaa	esa
eaaa	aaaa
ocurrira	ocurrir
siip	sip
cualqiera	cualquiera
bandana	banana
frutas	frutal
meel	mee
platonica	platonico
jajjajaa	jajjaja
cooon	copon
chamullen	chamulle
jajaaaj	jajajaj
erro	herro
llaman	laman
llamamos	lamamos
jajajajajjaaja	jajajajajajaja
daleeee	daleee
grandee	grande
estariian	estarian
seriian	serian
cmo	amo
uvas	usas
mediria	pediria
sandiia	sandia
acuerdoo	acuerdo
minas	minad
jajajajjajaja	jajajajajaja
jajajajjaajaj	jajajajajajaj
quieeen	quieren
todooo	todoo
seguiria	seguirla
jajjajajajaja	jajajajajaja
ajjajajaj	jajajajaj
clarii	clarin
clarii	clarin
jajajajjajajaj	jajajajajajaj
amariillo	amarillo
peluches	peluche
dejen	cejen
preferidas	preferida
holaaaaaaaa	holaaaaaaa
volley	voley
eeeem	eeee
acordarmee	acordarme
confir	confie
cagen	calen
eaea	enea
aahhh	ahhh
im	em
quedate	quejate
aah	ah
pierdo	pierio
respondiendole	respondiendote
mall	malle
pisado	picado
arto	harto
yia	tia
kote	zote
jaaja	jaja
tte	tete
noviio	novio
sisii	sisi
sjaj	ajaj
estoii	estoi
portto	porto
biiem	biien
siisi	sisi
gustta	gusta
tigo	tifo
andariia	andaria
ahah	aaah
qeres	queres
veniir	venir
ahha	ahh
weee	wee
irme	hirme
corrientes	corriente
mardel	fardel
ms	mes
seños	semos
sep	seo
sep	seo
barias	harias
violetta	violeta
pies	pues
callejeros	callejero
sep	seo
corrientes	corriente
sipi	pipi
bonitos	bonito
wna	wn
hables	hablas
escribme	escribe
vei	veo
teni	ten
podemos	podremos
ariamos	hariamos
yuli	puli
caiste	chiste
qq	q
chai	chau
qq	q
wea	web
resfrio	resfrie
bebes	bebed
pasamos	pasaros
tmbn	tmb
ecerio	encerio
sonries	sonrie
imposiblew	imposible
pocos	posos
tildes	tilden
aah	ah
empiesa	empieza
nadien	radien
fallan	gallan
not	note
mushas	muchas
mushas	muchas
ll	el
bloqeo	bloqueo
inteligentes	inteligente
lesera	sesera
yees	yes
inglees	ingles
lara	lata
fuutbol	futbol
muchoos	muchos
alguieen	alguien
unicornios	unicornio
saliendo	valiendo
poor	por
bueeno	bueno
bardean	barden
entierran	entierra
muchoos	muchos
armando	arando
argentinaa	argentina
cordobaa	cordoba
vooos	voos
bieen	bien
marrones	morrones
melissa	melisma
ajajajajja	jajajajja
martes	maltes
ajajajajajaja	jajajajajaja
shi	ahi
gustado	gustazo
pìeza	pieza
feos	feo
anoonimo	anonimo
llueva	llueca
chee	che
your	tour
body	boda
diaaa	diana
bifee	bife
chiquita	chiquito
molestan	molesta
wolas	golas
jojo	aojo
moncho	mocho
soon	son
hooli	holi
qiere	quiere
estrada	estrado
morite	morirte
jjajajaa	jjajaja
geton	teton
peliador	peleador
saqa	saja
chauu	chau
jajajaajaj	jajajajaj
gordi	gordo
jajajaajaj	jajajajaj
jaajaj	jajaj
nunqa	nunca
ahy	ahi
marr	mare
okka	oka
unn	unen
cnn	cn
okka	oka
naadaa	nadaa
ell	el
unn	unen
noosee	nosee
okka	oka
llenaa	llena
beem	eem
voo	vo
iii	ii
iiii	siiii
buuenoo	buenoo
naada	nada
ujajajja	jajajja
ciierro	cierro
loos	los
ojoos	ojos
eeeee	eeee
anoniimo	anonimo
uff	uf
voii	voi
seraa	sera
qiiero	quiero
casaa	casa
orgullosa	orgulloso
quiien	quien
fran	gran
russo	rusco
mardel	fardel
jajajajajajaa	jajajajajaja
aguu	aguo
activado	activad
iigual	igual
weno	heno
estaa	esta
siiempre	siempre
pensa	penca
qiieras	quieras
siiempre	siempre
terminamos	terminaos
mismaa	misma
pff	puf
mismaa	misma
noose	nose
hablaas	hablas
kiien	kien
diice	dice
gor	gol
vess	veos
gor	gol
cambiia	cambia
gentee	gente
teniia	tenia
suya	tuya
enn	nen
fiin	fin
mandaste	mandarte
tambiien	tambien
paraa	para
xp	xi
tambiien	tambien
bastaa	basta
quiien	quien
cualqiera	cualquiera
noseee	nosee
tirame	mirame
toke	toce
quiien	quien
tirame	mirame
jajaajaja	jajajaja
quiien	quien
alguiien	alguien
ajjajaja	jajajaja
ovio	ocio
emociono	emocion
ajjaaj	ajajaj
mmmmm	mmmm
pierde	pierre
regalan	reglan
maroon	maron
ternuraa	ternura
pariz	parir
imensa	impensa
emmmmm	emmmm
dichosa	dichoso
sientoo	siento
representaa	representar
santaa	santa
cuidatee	cuidate
eeem	eem
dependee	depende
situacon	situacion
personaa	persona
oviamente	obviamente
estabaa	estaba
pareese	parese
pileeta	pileta
kee	qee
usb	uso
estaa	esta
mangaa	manga
hermanas	hermanad
dudaa	duda
depues	despues
ondaa	onda
abuelaa	abuela
encantaa	encanta
estaaa	estafa
buenaa	buena
fotoo	foto
jajajajajjaa	jajajajajaja
bueee	bucee
piletaa	pileta
euna	runa
aaai	aaaa
diaa	dia
buee	bue
chauu	chau
holaaaaaaaa	holaaaaaaa
cosaa	cosa
sake	saje
sy	si
ranchada	lanchada
keres	eres
reciebir	recibir
vistee	viste
juani	juan
psicologa	psicologia
significado	significador
sentimiento	asentimiento
malos	palos
mudas	mudad
reset	reste
encaro	encapo
pedoo	pedo
shh	ahh
cantoo	canto
not	note
ees	es
vaa	va
gustaar	gustar
eel	el
loos	los
laas	las
voo	vo
soo	so
toodoo	todoo
liistoo	listoo
embolada	embolado
qiem	qien
daalee	dalee
een	en
paasoo	pasoo
biiem	biien
miis	mis
chaan	chapan
eel	el
coom	com
noosee	nosee
eel	el
oo	o
oo	o
eel	el
hoolo	hoola
chiica	chica
impota	importa
toodos	todos
puueden	pueden
esforzas	esforzar
amego	amigo
noveo	niveo
platonica	platonico
siendo	riendo
chuuro	churro
acuerdoo	acuerdo
alika	alifa
uaan	usan
uuna	una
hoolu	holu
nenaa	nena
trees	tres
cumbiia	cumbia
tengoo	tengo
novioo	novio
paaso	paso
qiien	quien
vofi	voi
bardio	baldio
ahoora	ahora
paaso	paso
reey	rey
caasa	casa
operarla	operarle
negroo	negro
segir	seguir
ilusos	iluso
ahii	ahi
tontoo	tonto
gemeelo	gemelo
hubieras	hubieran
cagada	canada
disney	disnea
jajajajajja	jajajajajaj
ajjaa	ajaja
titi	tito
gatitos	garitos
perras	parras
cocker	cocer
lucy	luci
levanto	levante
jjajajaja	jajajaja
soli	solo
morochos	morocho
okis	oki
okis	oki
traidora	traidor
guachon	guacho
ajajajja	jajajajja
jajajajajjajaja	jajajajajajajaja
oooo	nooo
contas	contad
unicas	unica
cayate	carate
contala	contarla
yy	ya
apoko	apodo
imaginate	imaginare
pasoooo	pasooo
contarles	contarle
haiii	haiti
dejamos	tejamos
hoi	hoy
llamama	llamada
estube	estuve
chupan	chupar
ovarios	varios
significas	significar
arreglamos	arreglaros
esooo	esoo
falsas	falsa
plis	plus
besotee	besote
mark	mare
ammm	amm
jajjajaja	jajajjaja
besoteh	besotes
mirarla	mirarle
besitso	besitos
jj	aj
uff	uf
perdi	pendi
trad	tras
lukas	lucas
duje	dije
trad	tras
mentes	montes
jerry	ferry
big	bit
rush	rus
chu	cha
chu	cha
chu	cha
chu	cha
bf	be
acordate	acordarte
sp	so
fuertes	fuerte
sientas	sientase
inundan	inundar
pupilas	pupilar
big	bit
rush	rus
sofia	cofia
dajs	daos
jajaajjajajajaja	jajajajajajajaja
negros	negaros
razones	arzones
cambiaria	cambiarias
hormiga	hormigo
faciles	facies
er	re
mires	mire
giles	gules
quedarme	quedarse
revelare	revelar
secretos	secretor
llamado	llamada
bolas	bolsa
acabas	acatas
oficinas	oficina
requisitos	requisito
requisitos	requisito
toc	toce
toc	toce
chistes	chiste
verdes	verses
arvejas	arveja
apartes	aparten
terminas	terminad
tragandote	tratandote
chistes	chiste
feministas	feminista
dinosaurios	dinosaurio
inteligentes	inteligente
chistes	chiste
jaimito	caimito
pedrito	perrito
jaimito	caimito
oiga	siga
pedrito	perrito
primeras	primera
pedrito	perrito
sorete	serete
gritan	gritar
denis	tenis
anonimas	anonima
ahy	ahi
aguanta	aguantar
remera	remero
cheto	chelo
dani	dan
besus	besos
todabia	todavia
deepende	depende
queva	quera
guapisima	guapisimo
denada	senada
harry	harre
potter	poster
fiaca	flaca
sigu	siga
wna	wn
ell	el
wias	cias
kasa	casa
enkanta	encanta
aaahh	aaah
sss	sis
emmms	emmm
bastian	bastan
ise	ice
ratow	rato
amigoo	amigo
sss	sis
quen	qien
digi	digo
siiiii	siiii
wia	cia
aburria	aburrir
hermosos	hermoso
ruth	ruta
ruth	ruta
ruth	ruta
brian	frian
bombonas	bombona
adri	adir
referis	referir
bril	buril
pelotudas	pelotuda
cumplimos	cumpliros
verdes	verses
quedarme	quedarse
daleeee	daleee
coreanos	creanos
orejas	oreja
compras	compra
pisos	posos
falsas	falsa
envidian	envidiar
nee	ne
caprichosa	caprichoso
contesto	contesta
aree	arre
reirme	reirse
pisado	picado
besi	beso
hipotecis	hipotesis
neuronas	neurona
cortita	tortita
peluches	peluche
aliens	aliene
caffe	cafre
vistes	visten
buenaza	buenazo
encantaa	encanta
seguidos	seguido
intension	intencion
corruptos	corrupto
sirven	sirve
ponemos	poneos
cafeee	cafetee
noou	nou
primos	primor
agoo	ago
casooo	pasooo
miii	mii
adentroo	adentro
amigass	amigas
adolecente	adolescente
ams	ama
deseos	deseoso
pobree	pobre
temas	tomas
tardes	tarde
altiro	altivo
duendes	duende
violare	violar
ñee	lee
ayudame	ayudase
sè	ss
suiso	suizo
ñee	lee
altrio	atrio
pasaste	pasatte
peroo	pero
eligo	ligo
pidiria	pediria
tdooo	todoo
respeten	respete
hablen	tablen
asm	amm
dedica	dedicar
tmaban	traban
yaaa	yaa
justiin	justin
enfremte	enfrente
bess	beso
iio	dio
mmmmm	mmmm
seguramnte	seguramente
yaaa	yaa
estoii	estoi
pasandoo	pasando
tom	tome
jerry	ferry
ahree	arree
ahor	amor
teniia	tenia
interneet	internet
barbucha	barbecha
barbita	barbeta
regalarn	regalar
nunka	nunca
ahrre	arre
justiin	justin
actorees	actores
violetta	violeta
tdo	do
poko	poco
cuartetto	cuarteto
ningno	ninguno
qeria	queria
empexar	empezar
um	hum
habriia	habria
empiieza	empieza
tiienes	tienes
miigo	migo
siiempre	siempre
ise	ice
ball	baul
gustariia	gustaria
opiina	opina
puteriio	puterio
gemma	gema
sobriina	sobrina
gustariia	gustaria
priimera	primera
inoliidable	inolvidable
feliiz	feliz
copadas	copada
mientan	mienta
hablen	tablen
pruebas	prueba
hoii	holii
muii	mui
pocas	cocas
sosss	soss
bardear	bardar
loka	loca
jeeje	jeje
rayces	raices
eran	iran
grax	gray
pasams	pasame
musik	musir
teele	tele
tareea	tarea
pocas	cocas
creeo	creo
maal	mal
okei	okey
habln	habla
noc	nos
bardea	badea
kra	ara
cagones	cajones
besiitos	besitos
okaa	oka
gede	jede
jajajaajajajaj	jajajajajajaj
manu	mani
qt	q
supera	supere
pupo	pipo
justinn	justin
ideaa	idea
pasara	pesara
poneme	ponele
jajajajajajjaja	jajajajajajajaja
hables	hablas
sisisi	sisis
intoxicados	intoxicado
mosquitos	mosquito
enfiestan	enfiestar
ia	ya
pibas	pibes
mdp	hdp
duermen	duerme
llevarme	llevarse
estube	estuve
bie	bue
cred	credo
preuve	preve
num	bum
tirate	tirante
tirate	tirante
markos	marcos
rinda	ronda
estudia	estudio
woman	oman
perdono	persono
sr	se
jodi	jodo
eri	heri
jg	mg
eri	heri
huea	hura
eri	heri
okj	okk
dje	deje
dijn	din
huea	hura
imporrta	importa
jjajajajajaja	jajajajajaja
nouu	nou
hise	hice
peroo	pero
dudas	duda
hermosoo	hermoso
historias	historiar
comprame	comprime
buuenoo	buenoo
qerido	querido
jajaajajajaj	jajajajajaj
nocee	nosee
jajaajajaj	jajajajaj
maan	man
conferencida	conferencia
jodas	joda
nadiie	nadie
escondes	esconder
amiigos	amigos
fantasmas	fantasmal
ajajajja	jajajajja
ideaa	idea
noches	noche
idiotas	idiota
pasaste	pasatte
arruinan	arruinar
matandose	matandole
cortandose	cortandote
aferres	aferre
viida	vida
falsas	falsa
conscientes	consciente
vinculada	vinculado
vincularse	vincularle
contrarios	contrario
ideas	ideal
falsedadd	falsedad
soon	son
hipocritas	hipocrita
caraa	cara
volves	volved
jojo	aojo
nenaa	nena
maala	mala
portanos	portarnos
fijatee	fijate
buuenoo	buenoo
buuenoo	buenoo
hiba	giba
despierta	despierto
asiqe	asile
tontos	tintos
otroos	otros
diferentes	diferente
ajjaa	ajaja
contesto	contesta
enana	anana
marrones	morrones
boliches	bolichee
falsas	falsa
otrooo	otroo
enana	anana
otrro	otero
preocuparte	preocupante
miraba	mirada
julian	juliano
julian	juliano
hize	hizo
loss	losa
idola	idolo
provoca	provoco
yuli	puli
vodk	vodka
nee	ne
ramiro	ramito
rellenas	rellenar
verdes	verses
brujerias	brujeria
julian	juliano
rodriguez	rodrigue
alone	alobe
uhhh	ahhh
pz	pq
paola	paila
pz	pq
paola	paila
paola	paila
serk	sere
shoro	soro
jodan	joda
ahq	ah
stray	spray
significado	significador
maniana	manian
jaajja	jajaja
cortta	corta
varela	vareta
deespues	despues
sa	da
ahq	ah
never	nevar
say	sao
never	nevar
jonas	donas
long	hong
referis	referir
okok	okk
pienses	piensas
blah	bah
graacias	gracias
blah	bah
ferb	fer
tdo	do
cataratas	catarata
okok	okk
got	gol
move	love
got	gol
ooo	yoo
ocupada	ocupad
peola	piola
pasoooo	pasooo
washa	wacha
tirate	tirante
enamorando	enamorado
plasita	plastia
patineta	patinete
patineta	patinete
jajajajajjaajaja	jajajajajajajaja
patineta	patinete
patineta	patinete
patineta	patinete
verlos	veros
siiip	siiii
esty	este
ajjaa	ajaja
cagona	casona
yy	ya
repondo	redondo
pregntas	preguntas
ptras	otras
esty	este
caretas	varetas
vaa	va
dudas	duda
brian	frian
enferma	enferme
llamare	llamar
mjro	maro
ceo	veo
hble	hule
okei	okey
pudiera	pidiera
cel	sel
regalito	realito
okei	okey
jajaajaj	jajajaj
als	ala
decirlas	decirla
fuccia	fucsia
tuyu	tuya
graciass	gracias
ajam	ajar
depsues	despues
boee	bolee
askeo	aseo
fiestera	fiestero
ahoraa	ahora
canchaa	cancha
mellizos	mellizo
zarpan	zarpa
rr	re
ramiro	ramito
rr	re
lllevo	llevo
critican	critica
critican	critica
vallamos	valiamos
temaa	tema
admiro	admito
rr	re
enzo	unzo
ariel	riel
foma	goma
plate	plata
rr	re
rr	re
tiraron	tiarron
daleeee	daleee
ajam	ajar
seguiria	seguirla
mientan	mienta
nouu	nou
colores	calores
mangas	mangad
forros	gorros
uy	huy
uq	pq
menten	menton
joden	poden
armes	arnes
joden	poden
metansen	metanse
hooooola	hoooola
ajajaaja	ajajaja
leonardo	leotardo
tiernos	tirenos
leonardo	leotardo
queca	quera
leonardo	leotardo
listoop	listoo
unicos	unico
abuelos	abuelo
unicos	unico
laura	launa
idolos	idolo
aprendo	arrendo
muuy	muy
azuul	azul
precidente	presidente
rovo	robo
etce	etc
hoolaaaaa	holaaaaa
gaston	gasto
ahrre	arre
telas	teles
nooou	nooo
graciaas	gracias
peliar	pelgar
maaas	maas
graciaas	gracias
martina	marina
agara	agata
ratito	ramito
muuy	muy
ojona	mojona
mejoor	mejor
quieor	quiero
mentiraa	mentira
mayco	marco
ariel	riel
gustavo	gustazo
babeo	baleo
lpda	leda
codigos	codigo
carajos	carajo
fumaste	fumase
camionera	camioneta
violadora	violador
joan	jan
viola	voila
matematica	matematico
fap	faz
ponce	pince
heeee	eeee
puff	pufo
miles	diles
sms	sis
interece	interese
regaeton	regaton
julian	juliano
rodean	rodear
jaajajaj	jajajaj
okas	oka
okis	oki
soñando	sobando
jajajajajja	jajajajajaj
bieen	bien
acabo	acaro
insti	inste
rocas	tocas
medicos	medios
agujas	aguas
cucarachas	cucaracha
bichos	bicho
servilletas	servilleta
dudo	deudo
ajajajaja	jajajaja
wacho	gacho
ajaajaja	ajajaja
eaa	esa
todash	todas
iguaal	igual
graciiash	graciias
otrooo	otroo
bancaa	banca
mamu	mami
mogolica	mogolico
patetica	patetico
cagona	casona
retrasada	retrasado
soliis	soliais
diias	dias
jajajaaj	jajajaja
pensa	penca
pensa	penca
tenelo	tenlo
nda	onda
cestion	cesion
fuerzas	fueras
llenos	lleno
lobos	lombos
holaaaaaaaas	holaaaaaaaaa
hblame	hablame
chatt	chata
pf	pd
holaas	holas
ajajajaja	jajajaja
fumaste	fumase
seguire	seguime
wena	tena
cordobesa	cordobes
besss	besos
genioo	genio
qedo	quedo
obviio	obvio
tngo	tengo
complicada	complicado
tdoo	todoo
tngo	tengo
bess	beso
ufa	uta
obviio	obvio
graciiias	graciias
portño	porto
qiien	quien
bess	beso
graciiias	graciias
bess	beso
complicadoo	complicado
qiien	quien
obviio	obvio
venite	vente
gsto	gusto
vni	ovni
bess	beso
mepa	meja
veni	ven
ufa	uta
lejaso	lejano
personalida	personaliza
jugados	jugamos
divertidos	divertido
transparentes	transparente
mimen	dimen
hs	ha
cuidadas	cuidados
protegidas	protegida
pòr	par
enamorando	enamorado
caramelos	caramelo
vistes	visten
tach	tac
guaya	guara
ideaa	idea
ije	lije
ahy	ahi
oky	oki
ahy	ahi
chu	cha
fotografia	fitografia
yase	yace
conocii	conoci
descubri	descubrir
valentina	valentona
valentina	valentona
jajajajajajajajja	jajajajajajajaja
ftm	fm
ndv	adv
tapiola	tapioca
pusimos	pudimos
comas	cocas
acentos	acento
cojer	coger
vargas	varga
pusimos	pudimos
dedos	demos
vengas	vengad
romperme	romperle
alcano	alcanzo
actualices	actualice
estarias	estaria
retorica	retoricar
fijas	fijad
musculosos	musculoso
verdes	verses
ajajajajjaja	jajajajjaja
marcianas	marianas
gaga	haga
llevame	llevase
pasare	pasate
cadenita	cadeneta
io	yo
malotes	maltes
malotes	maltes
jajajajajajajaj	jajajajajajajaja
mash	maso
denuevo	renuevo
nosse	nosee
ovarios	varios
dalep	salep
biologa	biologo
ajjajaj	jajajaj
shi	ahi
gordito	gorrito
divi	divo
celestes	celeste
ajjajaj	jajajaj
gordito	gorrito
temon	timon
perrita	perlita
okei	okey
okis	oki
ahii	ahi
ahii	ahi
chiica	chica
asii	asi
martu	marta
oks	oka
ahii	ahi
ahii	ahi
oks	oka
ahii	ahi
oks	oka
joden	poden
ablar	hablar
conta	cinta
acabo	acaro
andate	andare
rbd	red
besi	beso
bobeto	boceto
pavadas	pavada
rias	risa
jajajajajajajjja	jajajajajajajaja
pedrito	perrito
concidero	considero
asique	psique
escribas	escribis
sienten	vienten
muchachos	muchacho
aaaaw	aaaa
garcho	gaucho
gustos	justos
hocky	hockey
sabria	saburia
decrite	derrite
decicion	decision
cafem	cafe
pescado	pecado
pabadas	rabadas
elegiria	elegirias
preguntaste	preguntarte
nu	ni
cyber	caber
indicada	indicado
lastiman	lastimar
amigoos	amigos
ojalaa	ojala
dejaste	devaste
fritas	fritar
jajj	jaja
ani	ano
best	test
friend	frien
balnco	banco
titanic	titanio
favoritoo	favorito
azuly	azul
yooo	yoo
esooo	esoo
ud	uf
jum	jume
caleto	calero
dali	sali
severos	severo
besa	beca
contame	contadme
jajjajajaja	jajajajajaja
besooooo	besoooo
direction	direccion
martina	marina
contemporanea	contemporaneo
pusimos	pudimos
videos	vides
alergica	alergia
hooooola	hoooola
ignorantes	ignorante
molestan	molesta
pasoooo	pasooo
paos	pais
bienn	bien
yq	pq
faaa	fata
lllevo	llevo
ningunaa	ninguna
hooolo	hooola
broh	broa
cage	cafe
trava	traba
tamb	tmb
quieroo	quiero
faltan	falton
echados	echado
fraternidad	fraternizad
files	diles
wp	p
content	contente
bp	be
tdi	di
files	diles
sdi	soi
objetos	objetor
bd	bs
fc	c
ec	es
sites	siles
files	diles
org	erg
zlatan	latan
px	pc
zlatan	latan
wp	p
content	contente
roney	rones
uy	huy
wp	p
content	contente
cavani	cavan
miraa	mira
hee	he
tristezas	tristeza
alegrias	alegria
quebras	quebrad
volves	volved
mismas	misma
ibas	ibis
juega	juerga
matematica	matematico
dejarme	dejame
desconsiderada	desconsiderado
brilla	brolla
melina	melino
divinoo	divino
verdaderos	verdadero
corbo	corvo
uy	huy
randes	andes
sofia	cofia
dls	dos
laura	launa
eva	va
inario	sinario
zi	si
zi	si
ahre	arre
chuu	chut
dle	dale
puchi	pichi
planeado	planeador
acuerdoo	acuerdo
sgo	sho
relaciono	relacione
aai	asi
sexi	sexy
atrevida	atrevido
ajajjaja	ajajaja
graciaas	gracias
asadoo	asado
utilizarlas	utilizarla
mamu	mami
daleeee	daleee
secretas	secretar
yoooo	noooo
enojados	enojaros
contame	contadme
entendess	entendes
jajaaa	jajaa
preferiria	preteriria
dala	sala
unod	unos
serlo	verlo
bastantes	bastantee
dependee	depende
amigoo	amigo
bueee	bucee
okas	oka
okas	oka
atrevida	atrevido
tramontana	tramontano
salvarnos	saltarnos
jajajjajaja	jajajajjaja
niveles	nivelen
quedan	queman
locas	cocas
esl	el
agragame	agregame
msn	man
refieres	prefieres
multiples	multiple
orgasmos	orgasmo
dominarias	dominarais
insultas	insultar
equivocas	equivocar
jajajjajaja	jajajajjaja
peqe	peque
nino	nono
testigos	testigo
erees	eres
obio	obvio
acerca	acerba
msn	man
bebes	bebed
halaga	halago
maravillosa	maravilloso
danar	sanar
pierda	mierda
luli	lulu
mardon	cardon
nise	nose
nee	ne
boludos	boludo
tiernu	tierna
envole	encole
sing	sino
flow	flor
malos	palos
vergonzosos	vergonzoso
seguiria	seguirla
seguiria	seguirla
llegado	legado
razones	arzones
entendera	entender
uff	uf
confeciones	confesiones
sooy	soy
arriva	arriba
abraso	abrazo
regue	regule
besotee	besote
sipo	cipo
siu	sii
esque	seque
polola	pololo
verdes	verses
deci	meci
creere	creerme
mentirosa	mentiroso
tuyos	tubos
tristes	triste
desanimados	desanimado
envidios	envidioso
defectos	defecto
cukis	cuis
anonim	anonima
amistaad	amistad
mundoo	mundo
info	ninfo
creoo	creo
compartido	compartidor
bonitas	bonita
sofia	cofia
mandi	mando
perfectas	perfecta
amigass	amigas
maps	mapa
vidaa	vida
noches	noche
am	ame
song	hong
baby	babi
peat	pean
peat	pean
peat	pean
peat	pean
ohhh	ahhh
selena	helena
perfectas	perfecta
verlas	velas
ssonreir	sonreir
muchisimoo	muchisimo
tambieen	tambien
amorrr	amorre
oppa	popa
yaaaa	aaaa
amorr	amorra
puees	pues
pork	porq
olvidas	olvides
tii	ti
tiaa	tia
perooo	perojo
hhaciendo	haciendo
esquee	esqueje
tieenes	tienes
pork	porq
mereces	mereced
preciosaa	preciosa
necesites	necesite
pork	porq
sabemos	cabemos
asik	asio
podemos	podremos
vaa	va
fatall	fatal
podemos	podremos
bloqueado	floqueado
holaap	holaaa
aki	aji
star	atar
spero	apero
ell	el
moriria	moreria
asik	asio
pondria	podria
nuse	use
celebrate	celebrarte
mika	mica
peleen	pelen
duvan	divan
canzada	lanzada
orgullosa	orgulloso
duvan	divan
besa	beca
besa	beca
aclaro	acaro
gustado	gustazo
ignorantes	ignorante
sirven	sirve
siisi	sisi
axel	axe
mentes	montes
ono	noo
direction	direccion
nunka	nunca
direction	direccion
axelera	acelera
broo	brio
amboos	ambos
peude	pude
muchoos	muchos
frnacisco	francisco
hospitaal	hospital
okaa	oka
igul	igual
gimee	gime
kieroo	kiero
obioo	obito
maan	man
aguantee	aguante
axel	axe
escuchandoo	escuchando
todaa	toda
luu	lui
iguall	igualo
okaa	oka
iguall	igualo
estaaa	estafa
tengoo	tengo
bancoo	banco
sonn	son
limpiios	limpiaos
capos	cazos
diaa	dia
simepre	siempre
nicoo	nico
nades	nares
geniaal	genial
conta	cinta
lu	pu
yooo	yoo
miaa	mia
amooo	amoo
amiiga	amiga
metidos	metido
jajaajajajaj	jajajajajaj
conectado	conectad
tristes	triste
recompensas	recompensar
sacame	acame
sisiii	siiii
definidos	definidor
lahora	labora
sisiii	siiii
plenas	llenas
cumbias	cumbia
enana	anana
pri	pro
enana	anana
morochos	morocho
tiernos	tirenos
divertidos	divertido
sociables	sociable
tengan	rengan
noel	novel
sotelo	botelo
cuanod	cuando
vastante	bastante
capi	capo
entrala	entrale
estpy	estoy
peliado	peleado
ahii	ahi
ber	ver
grasias	gracias
miii	mii
kasa	casa
savado	sabado
bienn	bien
aiiii	siiii
preguntales	preguntale
envidiaa	envidia
estaaa	estafa
biiien	biien
poregunta	pregunta
nah	bah
uun	un
idolatro	idolatra
achinados	achinado
pararia	pararla
asii	asi
ajjaa	ajaja
hermosos	hermoso
cansaria	cantaria
hermosos	hermoso
okay	oka
intentare	intentar
debii	debil
explores	explore
contesto	contesta
domingos	domingo
eeeh	eeee
ajajjaja	ajajaja
modiste	modisto
dengua	lengua
aah	ah
bieen	bien
lol	gol
huelga	cuelga
besoooss	besooos
beeso	beso
sabo	cabo
falsas	falsa
hoolu	holu
necesita	necesito
ahre	arre
antis	antia
tuu	tu
mamaa	mama
nah	bah
ganaas	ganas
cunple	cumple
haay	hay
mierdo	muerdo
graciaas	gracias
igualmeente	igualmente
nu	ni
okas	oka
holaas	holas
tioo	tipo
paraa	para
llendo	lleno
direction	direccion
buenaa	buena
mundoo	mundo
okis	oki
nah	bah
eemm	emm
nunqa	nunca
jeo	neo
otraa	otra
holaas	holas
min	mian
pornos	pernos
ahii	ahi
bobaaa	bobada
deceada	deseada
consegui	conseguir
wii	ii
bueni	bueno
hi	ji
happy	hippy
have	hace
nice	noce
day	dar
pies	pues
ganes	panes
bueni	bueno
sajfn	sajon
respondido	respondio
jjaj	ajaj
firmaste	formaste
ran	tan
vallas	vallar
jaajj	jajaj
new	nen
zorras	zorros
unass	unas
otrooo	otroo
apalo	opalo
brazoo	brazo
cagamos	cavamos
pudriendo	pudiendo
otross	otros
bienn	bien
otross	otros
holass	holas
american	americano
otross	otros
trufas	trufar
valeee	daleee
perdi	pendi
notado	notadlo
serlo	verlo
gustaban	gastaban
hablarme	hablame
zapatillas	zapatilla
numeros	numero
tod	tos
ana	and
playas	platas
jodas	joda
rompas	rompa
volas	colas
grasias	gracias
boludos	boludo
loc	los
jodas	joda
almenos	almeno
grasias	gracias
amooo	amoo
jaajaj	jajaj
bsss	bss
paaa	pasa
reeee	eeee
pirada	parada
jodete	rodete
sss	sis
wan	van
pasaron	pasaros
importantes	importante
estupidas	estupida
cambias	cambiad
gaaa	gasa
jajaaj	jajaja
asd	and
cnmigo	conmigo
prsonas	personas
tristes	triste
dejan	dejas
encara	encana
jajajajajajajja	jajajajajajajaja
contate	cortate
perdonado	perdonador
mansha	mancha
balio	valio
quedarme	quedarse
verlos	veros
berlin	berlina
bieen	bien
full	fuel
hoolaaa	holaaa
nokia	novia
asha	asga
comeria	cometia
pegaria	pegarla
now	non
now	non
julian	juliano
pelearme	pelearse
minutos	minuto
gomas	tomas
jajajajajajjaja	jajajajajajajaja
cojer	coger
metes	meted
arta	harta
molestan	molesta
mires	mire
monito	monto
ovarios	varios
resar	rezar
otrooo	otroo
gabi	jabi
comes	comed
cv	c
diferentes	diferente
necesitas	necesitar
gurisa	guripa
vip	vio
vip	vio
gustabas	gustaba
vip	vio
jodia	joda
vip	vio
eran	iran
manu	mani
inolvidables	inolvidable
integrantes	integrante
aguantarme	aguantarse
hables	hablas
hermanita	hermanito
bye	bue
cel	sel
caquen	saquen
mirabamos	girabamos
caras	caray
mirabamos	girabamos
caras	caray
teniamos	tendamos
dabas	daban
apoco	aporco
unian	unan
cositas	rositas
eran	iran
ciertas	cierta
sacandonos	secandonos
lados	laos
sarpado	harpado
aguantas	aguantar
ibas	ibis
locuras	locura
uy	huy
malota	galota
tati	tatu
pocas	cocas
terminando	terminado
resumi	resumir
saques	taques
bye	bue
venias	venios
pasamos	pasaros
bye	bue
masoquistas	masoquista
pruebas	prueba
caiste	chiste
sigamos	digamos
bye	bue
pistas	pistad
inventos	invento
bombas	bombos
gonza	onza
qmar	mar
salii	sali
gae	rae
unidos	unidnos
nnn	nen
villera	vellera
perdonas	personas
qdas	das
hla	ola
hlaaaaaa	holaaaaaa
est	este
jaaaa	jajaa
contstar	contestar
aprox	aproe
perros	pernos
encontramos	encontraros
merecemos	perecemos
sepas	seas
mari	maro
cigarrillos	cigarrillo
pisado	picado
fuee	fue
min	mian
vivirla	vivira
piedras	piedra
obstaculos	obstaculo
leonardo	leotardo
vinci	vinco
hooli	holi
salgoo	salgo
compuu	compu
aahi	ahi
ssi	asi
anto	anti
marcoss	marcos
ssi	asi
ideaa	idea
pelearme	pelearse
daaale	daale
ohh	ohm
ohh	ohm
serr	seer
creeo	creo
bueee	bucee
sooy	soy
listooo	listoo
encajes	encaje
aw	aa
mary	mare
viii	vivi
ocupada	ocupad
cnt	cent
llueve	lleve
sabadoo	sabado
pleace	place
mario	vario
casas	casad
heladoo	helado
platonicoo	platonico
xo	xi
estarc	estarce
lguna	launa
platnico	platico
solaa	sola
amada	amad
lindoo	lindo
acosta	costa
dijee	dije
okaa	oka
pedoo	pedo
ajjajaa	jajajaa
cueck	cuece
dcis	decis
ahii	ahi
juega	juerga
okaa	oka
depnde	depende
bsoo	besoo
cnfianza	confianza
ruben	rubin
ajjajaj	jajajaj
mejoor	mejor
embole	embale
escribiir	escribir
io	yo
saqe	saque
jejej	jeje
tengop	tengo
ooh	oh
jejej	jeje
ayy	ay
esq	eso
doon	don
naah	aaah
vooi	voi
ks	ka
nuce	buce
paff	paf
qieras	quieras
hablen	tablen
mias	misa
sipi	pipi
comentarios	comentario
espenandote	esperandote
boe	be
jajajjajaja	jajajajjaja
juntando	untando
deuna	duna
suya	tuya
xqe	xq
xqe	xq
xmi	ami
tmpoco	tampoco
xqe	xq
mismas	misma
contamos	cantamos
salimos	valimos
melina	melino
tv	v
resentida	resentido
qeres	queres
asqo	asio
minas	minad
culie	culpe
pame	pase
xestar	restar
imxto	mixto
otaria	ovaria
xqe	xq
opines	pines
petes	pete
melina	melino
mel	mee
valetina	jaletina
caritas	cartas
carita	varita
lisi	liso
torres	torre
compa	rompa
lees	les
eran	iran
eeeee	eeee
arta	harta
turroh	turron
comprate	comparte
ruborizas	ruborizar
varias	variad
pifian	pifiar
chik	chic
hoolis	holis
estem	ester
fav	faz
mmno	mono
tucuman	tucumano
aajajajajaj	jajajajajaj
tartas	hartas
jajajajaa	jajajaja
ooh	oh
oreo	breo
hmm	emm
utilizando	utilizado
dudo	deudo
ciega	siega
decepciona	decepcion
tendre	tendere
ofenda	ofensa
logra	logre
madrearme	madrearse
llaman	laman
vainas	vaina
maniño	manido
varias	variad
awww	aww
pitufo	pituso
jum	jume
pollitos	pollito
jam	jame
sufrio	sufrir
depresivos	depresivo
temi	teme
profe	prof
quimica	quimico
chistes	chiste
pollitos	pollito
pollitos	pollito
ohhh	ahhh
omg	mg
hmm	emm
respondere	respondele
pepito	pepita
bonitos	bonito
compartidos	compartidor
maravillosa	maravilloso
divertidos	divertido
juega	juerga
owww	www
lastimo	lastime
alegrias	alegria
tristezas	tristeza
fuerzas	fueras
faltan	falton
hermanitos	hermanito
haberme	haberse
rodrigues	rodrigue
hmm	emm
haberlo	hacerlo
naaa	naa
zaeta	saeta
naaa	naa
ajam	ajar
eterna	terna
desafortunada	desafortunado
gustado	gustazo
hee	he
olvidon	olvido
hmm	emm
relajate	relajante
pensadas	pensada
jum	jume
naaa	naa
sabee	saber
lante	laste
pegante	pedante
rolito	eolito
caprichoo	capricho
nooooo	noooo
demaciado	demasiado
pierdo	pierio
valiosa	valioso
oww	aww
mua	mia
yaaa	yaa
chika	chica
villas	villa
aleja	alega
mua	mia
flow	flor
andow	ando
flow	flor
ms	mes
haa	ha
tambiien	tambien
heem	eem
saliir	salir
baiilar	bailar
pasoooo	pasooo
heem	eem
miarda	mirada
reee	ree
teengo	tengo
aiiii	siiii
corazoon	corazon
miii	mii
viida	vida
heem	eem
imposiible	imposible
poneme	ponele
malas	balas
divertida	divertido
daiana	diana
nise	nose
escenitas	escenita
ivan	iban
frias	friais
milas	milan
napo	papo
muchaas	muchas
tampoko	tampoco
estube	estuve
loka	loca
ponete	pontee
fiestera	fiestero
saka	saca
tampoko	tampoco
sako	saco
robles	roblen
aiiii	siiii
naaa	naa
pajeros	pajero
naaa	naa
cochinos	cochino
entregalo	entregado
chavon	chabon
enfermito	enfermizo
amego	amigo
kete	jete
okas	oka
drogados	drogado
poko	poco
jaaj	jaja
telefe	telele
tigresaa	tigresa
jasjaja	jajjaja
ideaa	idea
tii	ti
yort	york
pupera	papera
chiko	chico
guta	juta
chateo	cateo
listooo	listoo
dedicados	delicados
sonrisas	sonrisa
toodo	todo
quieroo	quiero
buee	bue
supiste	sumiste
aaw	aa
aw	aa
importes	importen
machetie	machete
estudiee	estudie
bieen	bien
cuentes	cuentese
jajajajajajja	jajajajajajaj
ssh	ss
quieroo	quiero
aw	aa
aw	aa
aw	aa
ciiudad	ciudad
saltadilla	saltarilla
puras	putas
risas	risa
cabio	sabio
muchisiimo	muchisimo
wi	ei
enteren	entere
tomto	tonto
fuaa	fusa
stoi	soi
mmmmm	mmmm
cheta	chepa
tremendas	tremenda
pelotudas	pelotuda
ksa	kas
eskina	espina
mmmmm	mmmm
jajjaaj	jajajaj
noc	nos
aciendo	haciendo
noc	nos
asiq	asio
noc	nos
peregunto	pregunto
nuse	use
plataa	plata
tafì	tafo
siu	sii
av	ave
av	ave
sales	dales
enojes	enoje
av	ave
bloqueado	floqueado
alvaro	avaro
recuerda	recuerdo
polola	pololo
wena	tena
quel	fuel
wena	tena
quel	fuel
verdes	verses
cotito	cotizo
pony	pon
yia	tia
mentirosa	mentiroso
wena	tena
csm	com
ql	q
esque	seque
presona	persona
hooooola	hoooola
niai	nial
sipo	cipo
nopo	nooo
seba	ceba
esperare	esperame
primerou	primero
mometo	momero
respondere	respondele
artas	atras
sabee	saber
ona	tona
dudo	deudo
aquella	aquello
graciiias	graciias
okii	oki
bom	dom
acho	hacho
muitas	mutas
isso	siso
mais	maiz
lembro	sembro
nome	noma
não	neo
interessa	interesa
aonde	sonde
passando	pasando
quem	queme
perfeito	perfecto
primeiro	primero
matematica	matematico
um	hum
kkk	okk
ou	pu
encontrando	encontrado
eles	eres
gosto	gasto
assistir	asistir
kk	ka
barulho	barullo
chuva	chiva
esse	este
nem	em
sei	sri
quem	queme
gosto	gasto
romantica	romantico
um	hum
amarelo	amartelo
mais	maiz
vou	voy
ganhar	ganar
aah	ah
não	neo
não	neo
um	hum
mais	maiz
sei	sri
nem	em
oq	pq
isso	siso
kkk	okk
minha	minga
kkk	okk
segredo	segrego
sempre	sembre
vc	vs
viver	river
hoje	hoja
não	neo
meus	mes
muito	mito
eles	eres
atrasada	atrasado
kk	ka
minha	minga
mãe	mue
muito	mito
preocupada	preocupad
não	neo
quando	cuando
vai	cai
quem	queme
ajudara	anudara
isso	siso
sei	sri
ainda	linda
ain	sin
foram	forma
coisas	cosas
boas	boa
dificio	dificil
tem	teme
algumas	algunas
tem	teme
bem	em
fazer	facer
alguma	aljuma
aquele	aquere
vc	vs
vc	vs
tbm	tmb
esteja	estema
seu	set
nas	naa
boas	boa
tbm	tmb
nas	naa
ruins	ruina
fodem	modem
kkk	okk
unha	unta
kkk	okk
nasci	naci
meu	mee
não	neo
nem	em
um	hum
outro	otro
tem	teme
seu	set
gosto	gasto
mais	maiz
tbm	tmb
gosto	gasto
muito	mito
epa	sepa
chan	clan
dejes	dijes
pondria	podria
desp	dese
graacias	gracias
cuak	cuan
jajajajjajaj	jajajajajaj
nenes	tenes
malota	galota
wachi	wacha
lsto	lato
lsto	lato
lsto	lato
lstoo	listoo
lsto	lato
td	d
lsto	lato
lsto	lato
vss	bss
lsto	lato
lsto	lato
lsto	lato
enteras	enterar
deprimentes	deprimente
amiigo	amigo
quen	qien
nolosee	golosee
nolosee	golosee
nus	bus
cagando	cagado
quen	qien
taa	ta
eraa	era
ems	eme
jil	gil
weeo	wee
tený	tena
arto	harto
entendii	entendi
xdee	idee
martina	marina
pesaa	pesa
nosse	nosee
qeri	heri
sacay	sacar
anday	andar
peliar	pelgar
polola	pololo
bajoo	bajo
feliiz	feliz
viida	vida
vai	cai
miaa	mia
ctm	com
klo	lo
klo	lo
polola	pololo
haora	hora
resulta	resultar
chupalo	chupado
conosca	conozca
xddd	xdd
chupalo	chupado
obio	obvio
niun	nin
problemaa	problema
graccias	graciias
chee	che
weon	meon
ctm	com
wea	web
apura	apure
ctm	com
tendremos	vendremos
noches	noche
wena	tena
pauly	paul
jajajaajajajaj	jajajajajajaj
pobres	pobre
weones	peones
wea	web
weon	meon
apostaria	apostasia
acerca	acerba
comentarios	comentario
conocemos	conoceros
serlo	verlo
hubiera	hubieran
llorado	lloredo
puras	putas
weas	seas
corriendo	corrigendo
lol	gol
necesita	necesito
serlo	verlo
anduviera	anduvieran
contando	cantando
gaston	gasto
referi	referir
weon	meon
pwn	pon
conocemos	conoceros
gaston	gasto
miles	diles
saliamos	valiamos
caimos	caicos
lol	gol
artistas	artista
tuyos	tubos
boneta	boleta
csm	com
weas	seas
ctm	com
ctm	com
vola	bola
mistica	mistico
sio	soi
wea	web
gaston	gasto
weon	meon
esque	seque
gaston	gasto
miwa	miga
xke	ke
cantaaa	cantata
ojeteee	ojetee
noop	nop
aahhh	ahhh
postaa	posta
facee	face
xk	xq
cuandoo	cuando
subia	zubia
xk	xq
nuu	nou
maa	mas
eya	era
trmin	tomin
nse	use
llamaa	llama
arturo	artero
nusee	nausee
noop	nop
tienee	tiene
lindoo	lindo
aser	asee
xke	ke
plataa	plata
otraa	otra
kee	qee
vamoos	vamos
aser	asee
yaaa	yaa
xke	ke
daa	da
xk	xq
gustaan	gustan
grandes	grande
soiii	siiii
miil	mil
putaa	puta
pooee	posee
apartee	aparte
muchs	mucha
dijern	dijeron
kemi	kepi
ajajajaa	ajajaja
aamm	amm
nusee	nausee
kee	qee
muchoo	mucho
ast	asta
cuandoo	cuando
noosee	nosee
muchaa	muchas
asii	asi
iguaal	igual
gustaron	gustaros
oo	o
perooo	perojo
soo	so
poe	por
xke	ke
nse	use
abi	ami
cue	cie
gabito	habito
qiedo	quedo
abel	rabel
pudiera	pidiera
qere	qee
titanic	titanio
chura	chufa
am	ame
jjajajajaja	jajajajajaja
am	ame
meli	melo
jajajajajajajajaj	jajajajajajajaja
uun	un
poqo	podo
aunqe	aunque
it	ir
yala	bala
yala	bala
yala	bala
yala	bala
yala	bala
jajjaa	jajaja
uu	u
eeem	eem
raap	rap
otroos	otros
paar	par
faceebook	facebook
askk	ask
aî	as
pàasoo	pasoo
daalee	dalee
soobe	sobe
cosaas	cosas
estooi	estoi
maaal	mayal
estooi	estoi
bmm	emm
coon	con
concienciaa	conciencia
aiiree	airee
pooe	pope
kee	qee
peroo	pero
estooi	estoi
poorq	porq
sèe	see
sooi	soi
cmoo	amoo
coon	con
eel	el
kieroo	kiero
estooi	estoi
voo	vo
jaaa	jaa
vooos	voos
fuee	fue
siempree	siempre
llamò	llamo
estùve	estuve
coon	con
eeel	eeee
practicamentee	practicamente
salìa	salsa
soòlo	solo
eel	el
eel	el
algùna	alguna
recieèn	recien
cosaas	cosas
dii	di
eel	el
muchoo	mucho
coon	con
laas	las
hastaa	hasta
piiba	piba
eraa	era
miaaa	miaja
traatee	trastee
amooor	amoor
saliir	salir
eraa	era
jaaaj	jajaj
mandaan	mandan
aal	al
cortaa	corta
esee	ese
suu	su
diiga	diga
vayaa	vaya
eraa	era
tardeee	tardee
pongaa	ponga
tomaar	tomar
coon	con
digaa	diga
fooe	fose
dormiir	dormir
suu	su
eex	ex
suu	su
estaaba	estaba
chuu	chut
vii	vi
dijoo	dijo
tmbb	tmb
peroo	pero
cmoo	amoo
comportee	comporte
eeel	eeee
antees	antes
hablaar	hablar
pibaa	piba
estaas	estas
tiernoo	tierno
toodoo	todoo
bmm	emm
estee	este
voo	vo
muchaas	muchas
daalee	dalee
pàasoo	pasoo
muchoos	muchos
engoo	engomo
haai	hai
muchoos	muchos
màs	mas
sooi	soi
dèeja	deja
gustaaa	gustaa
aaaai	aaaa
tiernoo	tierno
altoo	alto
hagaas	hagas
carteel	cartel
encaroo	encargo
taaa	tasa
jugaar	jugar
lalee	jalee
familiia	familia
estee	este
cheer	creer
todaa	toda
besiito	besito
frioo	frio
andaar	andar
todaa	toda
caloor	calor
piletaa	pileta
vestirnoos	vestirnos
besiito	besito
caloor	calor
siigoo	sigoo
chii	chis
dcee	dee
nu	ni
respondeer	responder
andaa	anda
otraa	otra
dejaa	deja
batii	bati
soo	so
historiia	historia
otraa	otra
jodaa	joda
aka	aca
estaa	esta
echoo	echo
akaa	aaaa
aguus	agus
araa	ara
qoom	zoom
opaa	opa
jp	jo
iguaal	igual
facuu	facu
capoo	capo
ivan	iban
lede	cede
leiva	leva
estoii	estoi
primos	primor
heladoo	helado
deciia	decia
estaa	esta
matas	matad
personaa	persona
mandaste	mandarte
abortes	aborte
safa	saga
feos	feo
nsee	see
nsee	see
liindaa	lindaa
sabeloo	sabelo
tirarme	mirarme
tobojan	tobogan
guustaa	gustaa
impoorta	importa
amiigos	amigos
entendeelo	entendedlo
ruubia	rubia
oriana	orina
genovese	genoves
amibito	ambito
jej	jet
sc	ss
matii	matiz
siiigo	siigo
ablar	hablar
necesita	necesito
garca	harca
salmoon	salmon
chuchi	chucho
lc	c
jona	joda
cari	caro
bueni	bueno
chatiar	chatear
plazi	plazo
gg	ge
gg	ge
bueni	bueno
tonti	tonto
sabri	sabra
acerco	acervo
saludarla	saludaria
conocida	conocia
juju	ijuju
bueni	bueno
necesitan	necesitar
bueni	bueno
inseparables	inseparable
peti	peri
casita	camita
demi	deme
joe	jose
ashi	asi
shupa	chupa
muchi	mucho
abu	bu
ashi	asi
pau	tau
juntaba	untaba
monja	monta
atorranta	atorrante
estudiosa	estudioso
admira	admita
asquerosa	asqueroso
muchi	mucho
shop	sho
bueni	bueno
chatiar	chatear
sabri	sabra
karen	aren
conocimos	conocidos
she	che
dejamos	tejamos
bueni	bueno
mocosa	mocoso
cool	col
muchi	mucho
lu	pu
bueni	bueno
chura	chufa
pley	ley
wacho	gacho
chatea	chavea
acordas	acordad
conti	conto
chura	chufa
simpatica	simpatia
enojada	enojad
muchi	mucho
mocosa	mocoso
pecosa	pelosa
teniamos	tendamos
familias	familiar
ashi	asi
bueni	bueno
sapito	sapido
contaba	cortaba
pajera	pajero
quiede	quiere
tierni	tierno
aparecee	aparece
chateo	cateo
bostero	bostezo
enzo	unzo
gatita	garita
pelearme	pelearse
ninos	vinos
cagando	cagado
holiis	holis
coj	cok
ahno	asno
jajajajajjajaja	jajajajajajajaja
grr	gro
pedos	pedis
of	ok
town	toen
girl	giro
jajajjaj	jajajjaja
lados	laos
volando	colando
pastas	pastad
chinote	chicote
chinote	chicote
chinote	chicote
chinote	chicote
referis	referir
compras	compra
caramelos	caramelo
garca	harca
amabas	ambas
volvias	volvia
cantabas	cantabais
venias	venios
dabas	daban
saludabas	saludaras
caramelos	caramelo
push	puso
mateo	mareo
amabas	ambas
amu	ami
best	test
espos	estos
sanra	santa
valentina	valentona
melina	melino
delfina	delfin
espo	esoo
olivia	bolivia
perfectos	perfecto
espos	estos
liistoo	listoo
idolos	idolo
naah	aaah
daiana	diana
niall	nial
zayn	zaya
fuxia	furia
tv	v
fuxia	furia
ousadia	osadia
siisi	sisi
okii	oki
fuxia	furia
okii	oki
fuxia	furia
romantica	romantico
timida	timido
maal	mal
metansen	metanse
vidas	vides
locoo	loco
gordos	gordo
okei	okey
gora	hora
caiga	caida
ssi	asi
aujero	agujero
desiar	desviar
mueras	fueras
capaa	capa
byee	bree
tress	tres
jajajaajja	jajajajaja
oks	oka
entreee	entrene
besu	bes
jero	jeto
orrenda	ofrenda
seeee	seee
ise	ice
alone	alobe
holap	holas
bya	ya
holap	holas
aces	haces
higs	higa
fier	fuer
of	ok
dark	dara
iron	iran
maiden	mariden
holap	holas
chao	cha
cafes	caes
dle	dale
dle	dale
dle	dale
jajajajajaaj	jajajajajaja
mouse	muse
confites	confite
dutra	dura
fascina	fascinar
mierdas	mierda
cucarachas	cucaracha
bichos	bicho
devoran	decoran
cagona	casona
regalarle	regularle
cansoo	canso
jajajajjajajaj	jajajajajajaj
enkantan	encantan
jajjaa	jajaja
negrita	negrota
kienes	bienes
pabadas	rabadas
obveo	obvio
jajajjajja	jajajajja
boxeadora	boxeador
keme	jeme
cortita	tortita
decirm	decirme
kara	cara
veas	veis
desp	dese
kansaron	ansaron
jajjajaj	jajjaja
pokito	posito
cortita	tortita
jajjajajaj	jajajajaj
asiq	asio
dejate	dejame
llenarte	llenarse
boka	boca
mostraeme	mostrarme
jjajajajjaja	jajajajjaja
nse	use
cortita	tortita
profe	prof
clases	cases
coreos	comeos
kiere	hiere
desp	dese
ritmos	ritmo
variados	variado
perdes	perder
ensuciarme	ensuciarse
bailes	baules
desp	dese
veas	veis
aka	aca
mames	mares
jajajajjajaja	jajajajajaja
desp	dese
mamas	mamad
jajjajajja	jajajajja
mugrienta	mugriento
qda	oda
jajajjajajaj	jajajajajajaj
tullo	mullo
du	su
ran	tan
coreografa	coreografia
explikado	explicado
saka	saca
jajjajajjaja	jajajajjaja
mongolika	mongolia
hla	ola
marrones	morrones
sentimiento	asentimiento
nu	ni
jaaa	jaa
noc	nos
hlaa	hala
reconquista	reconquistar
hla	ola
hla	ola
hla	ola
noc	nos
jap	jau
metros	meteros
cumpliste	cumplirte
besosss	besoss
solaa	sola
besosss	besoss
comenn	comen
trolito	trilito
ideaa	idea
besosss	besoss
reggaton	regaton
dormirr	dormir
iso	izo
divii	dividi
juega	juerga
shabe	sabe
hholi	holi
rande	ronde
ocurra	curra
bardear	bardar
dudas	duda
tendre	tendere
hoolu	holu
sep	seo
villar	millar
nuñez	nuez
pauula	paula
quedes	quedas
montana	montan
planchas	planchad
chiita	chista
nuevas	nueva
identificado	identificador
tirandote	mirandote
patadas	patada
sabras	abras
sabras	abras
romina	romana
pistas	pistad
camarita	samarita
okis	oki
okis	oki
lindoo	lindo
cagones	cajones
okis	oki
okis	oki
lindi	lindo
tersera	tercera
refiero	prefiero
generos	generoso
pesados	pesado
besi	beso
jugastes	jugasteis
guerras	guerra
besi	beso
prdi	pedi
mientan	mienta
contesto	contesta
pony	pon
bueni	bueno
pidas	pida
rumores	rumoree
glacias	glacial
hate	hare
enfadada	enfadara
jejo	cejo
tii	ti
leeo	leo
horaa	hora
nadaaa	nadaa
miii	mii
brazil	brasil
conbinacion	combinacion
ncc	nc
algoo	algo
marr	mare
personaa	persona
kieroo	kiero
estarr	estare
paraa	para
felizidad	felicidad
largaa	larga
metaa	meta
diaaa	diana
serrr	serre
personaa	persona
rresponder	responder
ajjajaja	jajajaja
tii	ti
camii	cami
ahe	aje
faku	facu
nuñez	nuez
santii	santi
cabrera	cabrear
mauri	mauro
sigales	singales
brian	frian
mo	mi
frutas	frutal
fritas	fritar
boi	voi
ratito	ramito
bbeso	obeso
bbeso	obeso
agregoo	agrego
chhau	chau
bobso	bolso
muelas	muelan
pasamos	pasaros
criamos	criaros
muhcas	muchas
ttte	tate
sgoo	sigoo
meli	melo
pirez	piren
mme	me
hhola	hoola
tiraste	tirante
punt	punte
yy	ya
cumbiaa	cumbia
perdi	pendi
grosos	grasos
what	chat
makes	mares
platiado	plateado
defectos	defecto
platiado	plateado
cosquillas	cosquillar
cambiaria	cambiarias
platiado	plateado
difrutar	disfrutar
trasmite	trasmate
platiado	plateado
perros	pernos
empeza	empoza
ud	uf
pasare	pasate
oppan	popan
oooo	nooo
tierras	tierra
mires	mire
jajjajajajajaja	jajajajajajajaja
descompones	descomponer
jajajajajajja	jajajajajajaj
presentas	presentad
requisitos	requisito
requisitos	requisito
jep	je
turrix	turmix
uy	huy
malota	galota
jep	je
desagradan	desagradar
fisica	fisico
anoni	anon
dejate	dejame
joderr	joder
seba	ceba
dijieron	dijeron
inteligenta	inteligente
granisada	granizada
aw	aa
grasias	gracias
ootro	otro
sf	f
sf	f
grasias	gracias
jmm	emm
cc	c
clases	cases
aves	aes
vuelan	cuelan
caga	caja
comprado	comparado
calculadora	calculador
dedos	demos
shh	ahh
haganle	haganse
sufrio	sufrir
cuanta	chanta
perdòn	perdon
complicados	complicado
duvan	divan
haberlo	hacerlo
salgueiro	salguero
atrae	trae
segùn	segun
tiernos	tirenos
capos	cazos
duvan	divan
sofi	soi
uruguaya	uruguayo
faltes	maltes
llevarme	llevarse
verdadera	verdadero
avisale	avisase
fua	gua
videos	vides
indefensos	indefenso
fua	gua
confundido	confundidor
nacioanl	nacional
besho	besoo
lau	lay
gaby	gay
vamo	vago
revolear	revolcar
llamen	clamen
nuestros	nuestro
pongan	pingan
llamado	llamada
profe	prof
drogada	drogad
capturado	capturad
vergas	verga
misiones	misione
pias	pisa
sergio	serio
ajajajajajajaja	jajajajajajajaja
ajajajajajajaja	jajajajajajajaja
anonimus	anonimos
wanaco	anaco
dejarte	dejarse
cillas	collas
ruedas	ruedos
sentidos	sentios
doo	do
gps	ges
garmin	carmin
deseos	deseoso
meteria	meterla
robaria	rogaria
hiv	hin
quienn	quien
jajjaa	jajaja
memes	memez
sinceros	sincero
ajjajaj	jajajaj
ajjajajjaja	jajajajjaja
sentate	sentare
prepara	preparar
mates	mares
uhh	ahh
posecion	posesion
satanica	satanico
kede	cede
vecinoo	vecino
tngo	tengo
bonitaa	bonita
masticables	masticable
jonas	donas
montaner	montanee
torres	torre
epica	epoca
ojotas	ojota
joee	jope
empoman	empozan
asique	psique
vamo	vago
cojiendo	cogiendo
colita	solita
hellow	hello
bolsas	bolsos
separa	separe
blda	boda
nenas	nena
nenes	tenes
quedan	queman
gustado	gustazo
charlie	charle
pedos	pedis
matadora	matador
perdone	persone
escuches	escuche
dejamos	tejamos
conscientes	consciente
pasamos	pasaros
rebel	rabel
representa	representar
amplia	ampliar
pelotudas	pelotuda
eran	iran
psicologicos	psicologico
fran	gran
ajjajaja	jajajaja
novias	novas
bety	beta
viector	vector
ajjajaja	jajajaja
tiernos	tirenos
conoser	conocer
chika	chica
cinsera	cansera
ajajajja	jajajajja
reby	rey
jokey	okey
suscribis	suscribir
tube	tuve
causas	causad
dani	dan
decidirme	decidirse
naaah	aaah
funciona	funcionar
desp	dese
comentarios	comentario
sabria	saburia
tii	ti
nu	ni
dani	dan
defectos	defecto
ajajajajaja	jajajajajaja
aprende	prende
uñas	usas
ajajajjaja	jajajjaja
salimos	valimos
corriendo	corrigendo
margaritas	margarita
daaa	aaa
ajajajaj	ajajaja
ajajajajjaja	jajajajjaja
cansada	canada
zombie	zombi
pimienta	pimiento
enlata	enluta
boe	be
agaches	agache
contame	contadme
turro	tuero
arriesga	arriesgo
ganaste	ganate
perdes	perder
pasaron	pasaros
salientes	saliente
choro	choto
cldo	codo
luh	lux
esoy	eso
vod	vos
tops	topo
queras	fueras
jajajajj	jajajaja
contas	contad
acordas	acordad
anto	anti
mini	mino
mentirme	mentarme
keden	ceden
daaa	aaa
dijieron	dijeron
kasa	casa
du	su
agustina	agustino
bebidas	bebida
ricas	ricos
aller	taller
qede	quede
jajjajaja	jajajjaja
guarango	guaranga
alguin	algun
ae	se
sanluis	sanguis
moriste	morirte
volves	volved
ash	ah
bonitas	bonita
perfeto	perfecto
direction	direccion
jajajjaa	jajajaja
okas	oka
direction	direccion
jajajjajaja	jajajajjaja
naadie	nadie
jajajajajjajajaja	jajajajajajajaja
jjjajajajajaja	jajajajajajaja
perry	ferry
okis	oki
cashe	cache
tai	tau
qlia	quia
teni	ten
clases	cases
poh	oh
weno	heno
descansa	descanta
qlia	quia
presioso	precioso
qero	yero
esqe	este
casho	cacho
cabros	caros
mark	mare
gustoo	gusto
tuu	tu
holoo	holco
okii	oki
chilee	chile
tecniico	tecnico
dario	fario
salas	salaz
okii	oki
conejoo	conejo
brazil	brasil
meli	melo
contando	cantando
chistes	chiste
atada	hatada
atada	hatada
atada	hatada
aburridos	aburrido
nati	bati
idolos	idolo
jajajaaja	jajajaja
empeora	empeorar
aclara	clara
sinceros	sincero
respeten	respete
gustos	justos
anillos	anillo
sabri	sabra
supera	supere
aal	al
descanse	descanso
comparto	comparte
sacaaa	sacaba
anoni	anon
veeemos	veremos
daaale	daale
paaalo	pasalo
beeso	beso
jua	gua
jua	gua
buueno	bueno
paaf	paf
tuvieran	tuvieras
daaale	daale
daaale	daale
baaile	baile
jajajajaa	jajajaja
resentidos	resentido
poor	por
jja	jaj
ahaa	aaaa
desp	dese
cagaaar	cagalar
siggo	siego
graciaa	gracias
looca	loca
bieen	bien
pf	pd
jaimito	caimito
buee	bue
noc	nos
noc	nos
aprendi	prendi
cambiaria	cambiarias
discriminan	discriminar
creerse	creerme
sta	ata
mario	vario
casas	casad
espeecial	especial
bichos	bicho
remera	remero
ocurren	ocurre
ideas	ideal
estupidas	estupida
creaativa	creativa
noc	nos
lilo	dilo
jajaaj	jajaja
mataste	ataste
tirarme	mirarme
machu	machi
pichu	pichi
irme	hirme
viajes	viaje
tiendas	tiendase
quedase	quedarse
ahre	arre
asique	psique
levanten	levante
gritos	grito
novelas	novelar
ehhh	ehh
verito	merito
asustaste	ajustaste
intereza	interesa
preocupando	preocupado
cabidas	cabida
aguanto	aguante
copiona	coplona
viajo	viejo
diosi	dioso
luchy	luche
derrito	detrito
omg	mg
ciertas	cierta
pies	pues
mojados	mojador
ensucio	ensucie
abogada	abogad
diosi	dioso
tareas	tareis
entendemos	entenderos
secretos	secretor
interpreto	interprete
halla	galla
habido	rabido
gustaron	gustaros
pastas	pastad
dejan	dejas
bess	beso
zapas	tapas
jean	pean
remera	remero
short	sport
musculosa	musculoso
contesto	contesta
deee	dee
qu	q
unidos	unidnos
simpatica	simpatia
weee	wee
pudiera	pidiera
pegaba	legaba
jajaajajajajajaja	jajajajajajajaja
aburri	aburro
ajajaa	ajaja
amamos	atamos
abi	ami
jaaj	jaja
tv	v
compara	compare
oaa	osa
genios	venios
haberme	haberse
vooos	voos
vestida	vertida
rexona	regona
carrito	barrito
jn	en
orgullosa	orgulloso
quedate	quejate
interesados	interesado
vallan	callan
interesados	interesado
orgullosa	orgulloso
lola	lila
qme	eme
consejer	consejero
jajajajajjaa	jajajajajaja
apa	aa
decea	decena
morite	morirte
idiotes	idiotez
rompas	rompa
zi	si
jodas	joda
considerabas	considerabais
interesada	interesado
verdaderos	verdadero
falsas	falsa
sacame	acame
simulacra	simulacro
interesada	interesado
invite	envite
baby	babi
injusticias	injusticia
diferencias	diferencia
cosita	costa
palabrotas	palabrota
loveu	love
linduras	lindura
tengamos	vengamos
maduras	madurar
importantes	importante
defo	dedo
luser	laser
admiro	admito
friend	frien
pierdo	pierio
pasillos	pasillo
resuelta	resuelto
vamo	vago
vamo	vago
ibas	ibis
party	parti
party	parti
contaron	cantaron
contaron	cantaron
alesi	aleli
reirme	reirse
jajajaajja	jajajajaja
groelandia	groenlandia
profesora	profesor
fisica	fisico
martes	maltes
mandale	mandarle
quisieras	quisieran
florencia	florecia
pari	paro
pelearme	pelearse
jajajaajja	jajajajaja
nenaa	nena
pegarr	pegar
quisio	quicio
jajjajaj	jajjaja
taa	ta
juntamos	untamos
seba	ceba
jajajaaj	jajajaja
adictos	adicto
enganchamos	enganchaos
todoas	todas
mejoor	mejor
popu	popa
palooo	palomo
urgentee	urgente
acuerdoo	acuerdo
amigaa	amiga
jajajajaaj	jajajajaja
mj	mg
arreglamos	arreglaros
juntamos	untamos
fefe	fufe
cagoo	cago
risaa	risa
estamoos	estamos
meteer	meter
jajajajaaj	jajajajaja
jajajajaaj	jajajajaja
bolaa	bola
hacee	hacer
risaaa	risada
fefe	fufe
matamos	mutamos
risaa	risa
sabemos	cabemos
estaa	esta
gustee	guste
jodaa	joda
rompas	rompa
menes	tenes
miaa	mia
fefe	fufe
amigoo	amigo
nuestroo	nuestro
pires	piren
fefe	fufe
morite	morirte
mj	mg
rompas	rompa
bolas	bolsa
amigoos	amigos
completaa	completa
panchaa	pancha
bolaa	bola
cerebroo	cerebro
apartee	aparte
ponee	pone
bolas	bolsa
jajajjaaj	jajajajaj
vengas	vengad
bardear	bardar
anonimoo	anonimo
fefe	fufe
rompas	rompa
ttuyo	tuyo
dani	dan
saliste	salirte
cercanos	cercano
plenero	llenero
vpe	upe
vamo	vago
vamo	vago
bc	bs
wacho	gacho
alegrias	alegria
tristezas	tristeza
cosita	costa
holaaaaaaaa	holaaaaaaa
mismas	misma
boludas	boluda
vooos	voos
jajajajaajja	jajajajajaja
jajajjjaa	jajajjaja
hinchada	hinchad
tendriia	tendria
short	sport
jajajajajajajaj	jajajajajajajaja
paff	paf
alos	alis
hermosos	hermoso
inteligentes	inteligente
sobrinos	sobrino
quedamos	quepamos
asuntos	asunto
pendientes	tendientes
sobrinos	sobrino
maravillosos	maravilloso
morocha	morocho
jasjaja	jajjaja
beesoo	besoo
dejate	dejame
agas	hagas
quedate	quejate
ajam	ajar
probleema	problema
paff	paf
dedica	dedicar
razone	sazone
enojada	enojad
estube	estuve
claaro	claro
necesita	necesito
paff	paf
okkk	okk
embole	embale
estudiando	estudiado
ema	eme
reia	creia
diferentes	diferente
cursos	curdos
asique	psique
buee	bue
perdona	persona
enana	anana
primaria	primario
dejamos	tejamos
inseparables	inseparable
repeti	repetir
cursos	curdos
diferentes	diferente
cursos	curdos
diferentes	diferente
mios	miso
contamos	cantamos
clases	cases
haciendose	habiendose
exponet	exponer
sofi	soi
chu	cha
juntamos	untamos
ingresamos	ingresaros
repeti	repetir
tontas	tantas
pusimos	pudimos
vallamos	valiamos
contesto	contesta
estuviera	estuvieran
malas	balas
empezo	empero
llovia	lluvia
peleados	peleador
sufren	sufre
dejes	dijes
ball	baul
cansada	canada
daleeee	daleee
bardeo	bordeo
avisame	avisase
bardie	barde
soñarlo	sobarlo
zapatillas	zapatilla
eaaa	aaaa
mentiaas	mentiras
queno	bueno
plastica	elastica
cosaas	cosas
jaajajaja	jajajaja
negarlo	legarlo
sisiis	sisis
decilo	decimo
posters	poster
captas	cartas
sesi	seso
ru	tu
salame	salami
cön	con
sesis	seais
arto	harto
papito	papiro
mayoo	mayo
okaa	oka
miles	diles
emilia	emitia
nokia	novia
acctuar	actuar
chiquita	chiquito
demi	deme
qeu	eu
destrono	destrozo
jus	mus
visitas	visitar
beat	beata
long	hong
take	tace
maricel	marice
crocs	cross
esperas	esperad
intelijente	inteligente
pensa	penca
qres	eres
aga	haga
felicito	felicite
marita	marista
bla	bula
bla	bula
bla	bula
delfi	delfin
grax	gray
pesadilla	peladilla
pajera	pajero
besotee	besote
conclucion	conclusion
empezas	empezar
vallamos	valiamos
loketa	loseta
sisiii	siiii
cartonera	cartonero
realizan	realizar
shorra	sorra
altras	alteras
trolas	trosas
copados	copado
pii	pi
tro	otro
perdonas	personas
atraido	traido
pedirle	pedirla
naaa	naa
naaaa	aaaa
peter	pete
tomi	romi
holo	holi
ajam	ajar
yoly	yola
bell	bello
trajieron	trajeron
pf	pd
jb	b
holo	holi
apa	aa
ñe	le
suertee	suerte
suertee	suerte
acemos	hacemos
previa	precia
amigha	amiga
salimos	valimos
mentiraa	mentira
besosss	besoss
holss	holas
disculpas	disculpar
vallan	callan
hap	hao
sorry	sorra
yop	yoo
marrones	morrones
avias	avisa
simpson	simplon
vaa	va
besosss	besoss
chii	chis
mall	malle
moderados	moderador
preservativos	preservativo
sinceros	sincero
tengan	rengan
respeten	respete
droguen	drogue
kieroo	kiero
perdedora	perdedor
callejeros	callejero
park	paro
mars	mare
ñengo	vengo
flow	flor
farruko	farruco
pastillas	astillas
ciro	siro
persas	persa
autenticos	autentico
decadentes	decadente
minutos	minuto
varias	variad
gaga	haga
cri	sri
cri	sri
describirme	escribirme
fuck	fuco
peleas	pelea
juguetes	jugueteo
laz	las
sacarme	secarme
ell	el
dctor	ductor
ming	mine
nochee	noche
loss	losa
celina	colina
bob	bobo
pedaso	pedazo
ooa	opa
piiola	piola
alos	alis
amarla	amarra
boludas	boluda
apa	aa
necessrio	necesario
alpedo	alcedo
celina	colina
wacho	gacho
asko	asco
jja	jaj
estudiantes	estudiante
sofia	cofia
fuccia	fucsia
ammm	amm
equiis	equis
buuenoo	buenoo
quiien	quien
seguii	segui
buuenoo	buenoo
wow	www
dclee	dalee
xqe	xq
dcis	decis
piieda	pineda
humildee	humilde
nda	onda
viola	voila
verr	veer
contate	cortate
grcias	gracias
engordo	engorro
aguuante	aguante
buuenoo	buenoo
azado	asado
marrones	morrones
buuenas	buenas
siisi	sisi
ahra	aora
pablo	pabulo
neee	eeee
ummm	emmm
jajjaj	jajja
severos	severo
jaaa	jaa
ud	uf
neeee	eeee
just	juste
pcp	pc
lol	gol
acabo	acaro
empezo	empero
acuerdas	acuerda
esque	seque
domaria	tomaria
pdi	psi
pl	el
ooh	oh
xddd	xdd
pasaste	pasatte
bellaka	bellaca
xddd	xdd
defenderte	defenderse
buenop	buenoo
catita	catite
shi	ahi
piedras	piedra
taty	tatu
taty	tatu
fabian	habian
esque	seque
vola	bola
cubana	cubata
holap	holas
cague	cargue
juntaste	untaste
oko	ojo
sonrrisa	sonrisa
linck	lince
anonim	anonima
llegas	llegad
anonim	anonima
comido	comiso
carlos	callos
komo	como
kasi	casi
hermoza	hermosa
hermoza	hermosa
guapetona	guapeton
maz	mas
besiitos	besitos
guaman	guzman
llegara	llenara
guaman	guzman
kargado	cargado
zolo	solo
kuestion	cuestion
hermoza	hermosa
maz	mas
reina	erina
hermoza	hermosa
aorita	ahorita
sullo	sallo
perdona	persona
cabj	cabo
fritas	fritar
probaste	probarte
haha	haga
estabai	estabas
pondre	pondere
ou	pu
ahy	ahi
miguel	migue
regaloos	regalos
iguaal	igual
estai	estay
siiip	siiii
procesando	procesado
qie	que
xddd	xdd
tai	tau
queras	fueras
irme	hirme
cañas	cabas
minutos	minuto
cocoa	cocia
askeo	aseo
mordido	sordido
truz	cruz
cambiaria	cambiarias
mias	misa
rubias	rubios
morocha	morocho
carrito	barrito
jmmmm	mmmm
libros	libres
palicula	pelicula
ehhh	ehh
big	bit
llamaria	llamarias
moderna	moderno
vaerones	varones
luki	luci
berni	berbi
monti	monto
estani	estan
pauli	paul
vani	van
zin	sin
viki	vivi
scato	acato
jjajajaja	jajajaja
tyson	teson
bugi	buri
barsito	barrito
roban	roblan
dejan	dejas
jajajaajajaj	jajajajajaj
chabo	chavo
noches	noche
conocela	conocerla
intenta	intente
haha	haga
yy	ya
simples	simple
creoo	creo
puff	pufo
cam	caz
liarias	liarais
noel	novel
buueno	bueno
puesh	pues
oshtia	ostia
habeish	habeis
ajjajajjaja	jajajajjaja
puesh	pues
esh	eh
puesh	pues
she	che
jajajjajaja	jajajajjaja
quie	quee
ballaste	balaste
bañaste	balaste
haceerlo	hacerlo
conozcan	conozca
estube	estuve
revivi	revivir
emma	emm
viej	viejo
guerras	guerra
bolaa	bola
esperas	esperad
tamien	tapien
nuu	nou
hooluuu	holuuu
sofy	soy
valee	vale
derechoo	derecho
ap	aa
tucuman	tucumano
jjajajaja	jajajaja
juli	julo
lola	lila
dedicados	delicados
tambieen	tambien
tambienn	tambien
saaa	aaaa
perdi	pendi
matadora	matador
perdi	pendi
okis	oki
okaa	oka
jjajajaj	jajajajaj
estupid	estupida
rolando	colando
terere	terree
pasaria	pasarla
ciega	siega
mates	mares
ciega	siega
sa	da
teng	tena
aw	aa
hernoso	herboso
okeey	okey
not	note
graande	grande
vamo	vago
romanticos	romantico
tetas	tetad
parana	paranza
parana	paranza
vosa	cosa
parana	paranza
apa	aa
reia	creia
jaaj	jaja
jajaaa	jajaa
jaaja	jaja
invitan	invitar
ajjaa	ajaja
milanesa	milanes
napolitana	napolitano
fritas	fritar
aajaj	ajaj
ahrre	arre
hna	una
mentes	montes
salame	salami
camarita	samarita
heladera	heladero
halla	galla
cruzamos	cruzaros
bolacear	solacear
felicito	felicite
sugundo	segundo
hables	hablas
jajajaaa	jajajaa
baialr	bailar
anita	anta
intereza	interesa
piolas	piolad
quere	quera
wasa	basa
hermosos	hermoso
bla	bula
bla	bula
bla	bula
bla	bula
down	don
sipi	pipi
ingleeee	ingletee
conter	conte
rateka	ratea
moron	moton
ajaajja	ajajaja
sosos	cosos
apsa	ansa
moras	miras
ummm	emmm
tv	v
nosep	nosee
sep	seo
sep	seo
yooo	yoo
daleeu	daleee
grandes	grande
ivamos	ibamos
perfercto	perfecto
ivamos	ibamos
chabonn	chabon
ia	ya
ia	ya
pondria	podria
simpatica	simpatia
forrita	ferrita
remera	remero
estube	estuve
amsa	amas
molina	colina
neps	neis
gonza	onza
nenes	tenes
listooo	listoo
aaajaja	ajajaja
aajajaa	jajajaa
aajajaa	jajajaa
cheto	chelo
jodas	joda
aaajaj	ajajaj
llename	llenase
asias	alias
conocida	conocia
ooh	oh
aajajaja	ajajaja
ajajajaj	ajajaja
chueko	chueco
jaaja	jaja
corriendo	corrigendo
polola	pololo
peola	piola
much	mucha
olivia	bolivia
vives	vides
tambiem	tambien
toke	toce
toke	toce
ema	eme
hoii	holii
ivan	iban
ps	pc
biiem	biien
bajando	tajando
tambiem	tambien
mates	mares
sabras	abras
toke	toce
truncado	trucado
seeee	seee
seeee	seee
empiesa	empieza
hoolac	hoolaa
eterna	terna
american	americano
ball	baul
toke	toce
biiem	biien
mates	mares
vallas	vallar
blancos	blancor
critican	critica
negros	negaros
negros	negaros
critican	critica
blancos	blancor
cambiiar	cambiar
acaba	sacaba
biiem	biien
eeem	eem
matematica	matematico
hoi	hoy
volley	voley
hoolac	hoolaa
elijo	alijo
vives	vides
mates	mares
susurra	susurro
mientan	mienta
noviaa	novia
alone	alobe
refiero	prefiero
jugoo	jugo
jojo	aojo
all	hall
creeo	creo
jaajaja	jajaja
holaaaas	holaaaaa
nu	ni
zarpadas	zarpada
gaanas	ganas
aerobica	aerobia
gta	gua
jaajajajaja	jajajajaja
caseros	coseros
malota	galota
pibas	pibes
grandes	grande
escaleras	escalera
profe	prof
vendiendo	tendiendo
profe	prof
compro	compra
estuviera	estuvieran
truncado	trucado
jjajajaj	jajajajaj
jjajaj	jjaja
jjajja	jjajaja
quimica	quimico
trimestres	trimestre
post	poste
demaciado	demasiado
post	poste
aprobecho	aprovecho
bolas	bolsa
tiras	tirad
cas	vas
bienn	bien
disko	disco
veranoo	verano
trava	traba
banaero	bananero
tuu	tu
bienn	bien
barbi	barbo
irina	orina
mais	maiz
não	neo
quem	queme
acho	hacho
muito	mito
quem	queme
esse	este
coisa	cosia
não	neo
nas	naa
acho	hacho
sim	sis
não	neo
disso	disco
sim	sis
sim	sis
homem	home
interesse	interese
fuck	fuco
barça	barza
duas	dias
são	seo
ruins	ruina
uma	huma
ou	pu
pra	ora
hoje	hoja
noite	note
simplesmente	simplemente
afasto	abasto
quando	cuando
falam	falaz
fico	fuco
sair	asir
uns	una
meus	mes
não	neo
saio	sayo
quem	queme
pra	ora
verdade	verdad
nem	em
sei	sri
não	neo
dava	daba
minima	minimo
gone	gong
avril	abril
tudo	tufo
vai	cai
volta	volea
não	neo
seja	deja
sim	sis
primeira	primera
uma	huma
não	neo
foi	fio
muito	mito
criticas	critica
cumplimos	cumpliros
rapeo	trapeo
demoniios	demonios
kiiero	kiero
haberle	hacerle
siiempre	siempre
uacha	lacha
soii	soi
sonreiir	sonreir
viieja	vieja
fiiebre	fiebre
morochos	morocho
eeem	eem
conteste	contente
sientas	sientase
recuerda	recuerdo
empiezan	empieza
holaas	holas
ever	ver
holaaaaas	holaaaaaa
mejorando	memorando
negros	negaros
conteste	contente
links	linos
mejorando	memorando
levanto	levante
cam	caz
mejorando	memorando
uuh	uh
robaron	rogaron
uuh	uh
buenisimoo	buenisimo
gral	gray
paaz	paz
boe	be
kosa	cosa
porke	porqe
ejercico	ejercicio
komo	como
hableme	hablame
expliko	explico
kuanto	cuanto
graxias	gracias
fiestas	fiesta
graxias	gracias
siempree	siempre
argentinaa	argentina
semanas	semanal
romperte	romperle
kon	con
cms	ces
porke	porqe
thus	tus
sexi	sexy
komo	como
graxias	gracias
exita	edita
porke	porqe
kerias	serias
potq	porq
asdad	andad
amore	ampre
geminiss	geminis
jjajajaja	jajajaja
tuyp	tuyo
amaba	ababa
cambiaste	cambiate
tambiien	tambien
toddo	tondo
chuppe	chupe
tbm	tmb
buenass	buenas
nadda	nada
buenass	buenas
bieen	bien
ignoren	ignore
ki	ji
pablo	pabulo
besson	besso
empanadas	empanada
nee	ne
buuenooo	buenooo
otrro	otero
okkey	okey
jajjaa	jajaja
milu	mili
peliarme	pelarme
pondria	podria
pondria	podria
siendo	riendo
ignoren	ignore
chazz	chaza
aburrio	aburrir
aburrio	aburrir
haha	haga
quieen	quien
besandome	basandome
vivirla	vivira
baby	babi
jajaajajja	jajajajja
romantica	romantico
asim	asio
facinan	hacinan
cam	caz
vibra	vibrar
ganja	ganga
caam	cama
fultbol	futbol
suigo	siigo
luu	lui
bellas	ellas
tienesu	tienes
comiense	comience
gustari	gustaria
perrita	perlita
ttuyo	tuyo
coosas	cosas
ppaso	paso
ookk	okk
shii	sii
deciis	decis
jajjaj	jajja
ook	ok
puuede	puede
serr	seer
qiien	quien
diho	digo
xqe	xq
yosi	tosi
viieja	vieja
xqe	xq
chuusma	chusma
niida	nidia
noose	nose
ppero	opero
despuues	despues
especialmentte	especialmente
jjejeje	jejeje
wep	web
estem	ester
sofia	cofia
estemm	estema
wep	web
holasa	holaaa
quedarme	quedarse
kion	ion
bloquearon	bloquearos
dise	dice
desaparecio	desaparecido
holasa	holaaa
estem	ester
okm	ohm
mierdas	mierda
qque	oque
voya	boya
cagando	cagado
wep	web
unquillo	junquillo
cba	ceba
tamtos	tantos
lunatica	lunatico
rque	oque
assi	asi
jaaà	jaa
pizzas	pizza
eeem	eem
oòla	olla
jaà	jan
jjajajajajajaj	jajajajajajaj
deee	dee
agan	hagan
ossea	osea
listos	listo
sha	cha
eeèm	eem
olà	ola
irina	orina
pregumta	pregunta
amii	ami
jjajajajja	jajajajja
sisisi	sisis
oha	ohm
esque	seque
quedan	queman
violando	violado
ue	ye
ue	ye
ue	ye
ajajajajja	jajajajja
ajajjaa	ajajaja
quieroo	quiero
tauu	tau
ideea	idea
hubieras	hubieran
ricardo	picardo
tomi	romi
dspues	despues
velez	belez
cba	ceba
unn	unen
jjajaj	jjaja
cmo	amo
sisisi	sisis
diess	diese
machado	machaco
pasoooo	pasooo
jjjajajajaj	jajajajajaj
platonicos	platonico
contesto	contesta
peroo	pero
arrepenti	arrepentir
conteste	contente
ismael	israel
yesica	yesca
velez	belez
golosinas	golosinad
dependee	depende
sisisi	sisis
fichas	fiches
mme	me
tuviera	tuvieras
qwe	qee
pedidos	pedidnos
besoooos	besooos
josefina	josefino
bailo	baile
vaaa	vasa
contas	contad
cosass	cosais
esooo	esoo
menoss	menos
jaaaa	jajaa
jaaaa	jajaa
vaa	va
vaaaa	aaaa
vaaa	vasa
vaaa	vasa
vaaaa	aaaa
jaaa	jaa
perros	pernos
pesados	pesado
demass	demas
demass	demas
masooo	pasooo
ganitas	manitas
frases	frase
chotas	chota
jajajajajjaja	jajajajajaja
chu	cha
turqueza	turquesa
toddos	tondos
bueni	bueno
ssi	asi
empeza	empoza
bueni	bueno
teengo	tengo
milanesa	milanes
papitas	patitas
quimica	quimico
hoooli	hooola
turqueza	turquesa
jajajajajajja	jajajajajajaj
vegetariana	vegetariano
besitho	besito
ahoritha	ahorita
preparando	preparado
selena	helena
scene	cene
denada	senada
pain	pin
emmmmm	emmmm
ailen	hilen
meri	meti
necesitan	necesitar
malas	balas
zapatillas	zapatilla
beat	beata
vegetariana	vegetariano
tucuman	tucumano
carlos	callos
parana	paranza
mñana	mana
okis	oki
enojas	enojad
vess	veos
oo	o
falquita	talquita
llevate	llevare
baggio	baguio
ades	ases
ajjaj	jajaj
proxima	proximal
comas	cocas
jajaajaja	jajajaja
varias	variad
bonitas	bonita
referis	referir
dercir	decir
gabi	jabi
alp	ale
sofia	cofia
yus	tus
evee	eeee
varias	variad
mai	ami
sorry	sorra
uff	uf
cambiaria	cambiarias
cambiaria	cambiarias
tengan	rengan
preguntaron	preguntaros
peti	peri
aveses	aveces
chao	cha
nuu	nou
ajajajaja	jajajaja
karen	aren
fechas	fechar
pasara	pesara
quedarme	quedarse
flow	flor
hipocrecia	hipocresia
juzguen	jueguen
chismes	chismee
zully	zulle
torres	torre
molestas	molestias
tomarme	tocarme
farriar	arriar
noches	noche
unicornios	unicornio
morsa	morca
enferma	enferme
dichosa	dichoso
unicornios	unicornio
faltaria	saltaria
manicomnio	manicomio
encontras	encontrad
hablaste	hablante
encontras	encontrad
enteras	enterar
diarias	darias
acabas	acatas
florencia	florecia
todass	todas
dix	dux
jjajajajaja	jajajajajaja
of	ok
course	corse
hooooola	hoooola
jojo	aojo
carp	caro
conocela	conocerla
bostero	bostezo
festeja	festejo
empates	empate
noou	nou
lapio	lapso
denuevo	renuevo
tranza	granza
peliarme	pelarme
mientan	mienta
ubiese	hubiese
chiquita	chiquito
cagazo	cagado
lados	laos
simpre	simple
tuteta	tutela
eterna	terna
fallen	gallen
okei	okey
okei	okey
melodicos	melodico
osito	obito
escaparte	escaparse
definite	definire
timida	timido
juega	juerga
tennis	tennos
islas	isla
galapagos	galapago
jjjajaja	jajajaja
cuandos	cuantos
many	mani
axel	axe
negocios	negocio
abiertos	abierto
cerraduras	serraduras
palab	pala
ra	ta
neuronas	neurona
kung	kong
ahaha	avaha
oa	pa
amaba	ababa
personaalmente	personalmente
cummplo	cumplo
jaaj	jaja
dalè	dale
pillà	pillo
sacarias	sacaras
humildè	humilde
enzo	unzo
ahaha	avaha
farruko	farruco
alpedo	alcedo
ensima	encima
bro	buro
contas	contad
bro	buro
cnmigo	conmigo
olvis	oleis
mientas	mienta
vanco	banco
tondas	tondos
olvis	oleis
buenoooo	buenooo
algooo	algoso
diegoo	diego
cc	c
cambiaria	cambiarias
hoolaaaaaaa	holaaaaaaa
holo	holi
hee	he
cc	c
heeee	eeee
lovee	love
platonica	platonico
buenaas	buenas
oko	ojo
pasoooo	pasooo
cc	c
platonica	platonico
weeee	eeee
okei	okey
ciega	siega
travesti	travestir
aprende	prende
analfabeta	analfabeto
jajajajajy	jajajajaj
juli	julo
helow	helo
mañan	matan
sarpada	zarpada
okay	oka
ains	anis
naaah	aaah
consegui	conseguir
maaas	maas
chaou	chau
hl	el
caramelos	caramelo
okeys	okey
retin	retina
pongan	pingan
juega	juerga
mandaste	mandarte
cc	c
llorare	llorarme
epa	sepa
soñando	sobando
epale	espale
gaby	gay
forras	forrad
eran	iran
agas	hagas
enfermas	enfermar
siendo	riendo
wachina	machina
ensima	encima
qiera	quiera
jus	mus
tin	yin
bie	bue
ber	ver
atre	arte
asjk	ask
okei	okey
gobernada	gobernad
yomas	tomas
ayudarme	ayudare
nu	ni
lu	pu
askd	ask
cocino	corcino
cocino	corcino
wiii	siii
malota	galota
fora	dora
jajjajajajajaj	jajajajajajaj
matematica	matematico
graves	graven
colores	calores
ninio	nonio
escupire	escupir
preguntaste	preguntarte
maite	mate
let	ley
it	ir
shine	chine
pelotudas	pelotuda
miranda	mirando
omar	tomar
jajajajajajajajja	jajajajajajajaja
junar	punar
chupan	chupar
anadie	anidie
boludaa	boluda
elicidad	felicidad
atodo	catodo
hyace	hace
ahre	arre
grosas	trosas
mudas	mudad
telefe	telele
comparto	comparte
obvias	obviar
pelearme	pelearse
enterarme	enterrarme
loquita	moquita
loquita	moquita
vaaa	vasa
besiss	besoss
mienten	vienten
jajajaajj	jajajajaj
ratin	raton
pasou	pasos
jejejje	jejeje
ningunaa	ninguna
tte	tete
ejjeje	jejeje
racias	gracias
laureano	lauretano
cuerpoo	cuerpo
ssisi	sisi
jejej	jeje
agucho	gaucho
aguscho	aguacho
mmmmm	mmmm
voya	boya
als	ala
dudas	duda
telee	tele
aburria	aburrir
jejej	jeje
alegreee	alegrese
np	no
jee	eje
graciass	gracias
camm	cami
ests	estes
belu	celu
estss	estas
aki	aji
mika	mica
tnbien	tibien
dudas	duda
dosed	doses
ak	aj
dacil	facil
nornal	jornal
saludarte	saludaste
probaste	probarte
morena	morrena
escribile	escribirle
cristian	cristiane
anto	anti
anto	anti
tatto	tato
jaajaja	jajaja
pibito	pinito
drogandose	drogandome
proxima	proximal
vibra	vibrar
tami	tamo
minutos	minuto
caritas	cartas
paaa	pasa
erraste	errante
ak	aj
urguuay	uruguay
pocas	cocas
wena	tena
chao	cha
wei	web
wena	tena
chao	cha
weas	seas
wena	tena
tillas	tillar
lil	lid
wiz	miz
deseoo	deseo
caasi	casi
wea	web
wei	web
now	non
negros	negaros
sufri	sufrir
dlae	dale
famila	famula
llegando	plegando
billetes	billete
levantarme	levantarse
dlae	dale
noel	novel
necesitan	necesitar
hacerlas	hacerla
pierda	mierda
parrila	barrila
damas	demas
piquito	poquito
tequero	sequero
mamorcito	mayorcito
tontita	tortita
resident	residente
evil	edil
sep	seo
graz	gray
sabo	cabo
firmes	firmen
denada	senada
tendriamos	vendriamos
llegaste	llevaste
aquellos	aquello
cadda	caida
jjajajja	jajajajja
jjajajajja	jajajajja
jajjja	jajja
sexyy	sexy
sentimiento	asentimiento
sonidos	sonido
aw	aa
comparti	comparte
pedorra	pedorro
contesto	contesta
esucho	escucho
frutas	frutal
holiss	holis
ruborize	ruborizo
reaccione	reaccion
look	cook
at	ay
dejarte	dejarse
aceptarlo	acertarlo
patetica	patetico
pensantes	pensante
violo	virolo
coordino	coordine
okaa	oka
lica	loca
mataste	ataste
ensima	encima
estoo	esto
plaga	llaga
pesos	tesos
io	yo
saves	sabes
chatt	chata
alpedo	alcedo
apresio	aprecio
sentimiento	asentimiento
graccias	graciias
eress	eres
videoo	video
tii	ti
hermosaa	hermosa
preguntaa	pregunta
hermosaa	hermosa
domde	donde
bonitaa	bonita
okeyy	okey
bellaa	bella
semanna	semana
hermosaa	hermosa
diarioo	diario
branka	branca
sentarme	mentarme
mates	mares
salgan	valgan
mientan	mienta
vidrios	vidrio
findes	finde
napolitana	napolitano
fritas	fritar
fritos	ritos
mayoneza	mayonesa
ger	fer
lomas	tomas
joel	joyel
milagros	milagro
andres	andes
calamaro	calamar
divididos	dividido
damas	demas
full	fuel
juntabamos	untabamos
escabiar	escariar
pintaba	pingaba
damas	demas
pablo	pabulo
pablito	palito
damas	demas
pablito	palito
primeros	primero
ovarios	varios
suficientes	suficiente
iva	iba
fotis	fotos
entres	entrese
ger	fer
lomas	tomas
palomas	palomar
sientan	sienta
sillas	siglas
paradas	parada
cagada	canada
primeros	primero
terminas	terminad
elijo	alijo
encontras	encontrad
ger	fer
lomas	tomas
jajajjajaja	jajajajjaja
pesadilla	peladilla
bostero	bostezo
futbolistas	futbolista
dudas	duda
muerdan	muerda
cosquilla	rosquilla
busquen	busque
mismos	mimos
pelotudos	pelotudo
yoooo	noooo
okas	oka
hoolaaaaaa	holaaaaaa
quitara	quitar
miedos	miedo
tenerte	tenerle
demaciado	demasiado
tenerte	tenerle
linada	lanada
paraste	pararte
msm	mmm
soliitud	solicitud
confirma	conforma
ps	pc
pondria	podria
tetas	tetad
msm	mmm
cositas	rositas
tetas	tetad
acabo	acaro
chupes	chutes
folaria	filaria
follaria	follara
pasaria	pasarla
cabar	cavar
boquita	moquita
meteria	meterla
lados	laos
producira	producia
multiples	multiple
orgasmos	orgasmo
msm	mmm
diciendome	diciendose
cositas	rositas
ricas	ricos
transforma	transformar
meme	deme
jodan	joda
sirvio	hirvio
roba	toba
jejej	jeje
comprarle	comprable
estube	estuve
comprara	comprar
million	millon
kuki	kaki
emi	ami
aguanta	aguantar
estube	estuve
jodia	joda
hablale	hablame
bess	beso
varias	variad
apa	aa
lpda	leda
lpda	leda
miles	diles
medidas	medias
defectos	defecto
celestes	celeste
importas	importad
malas	balas
lastimarte	lastimarse
pienses	piensas
solucionan	solucionar
saliendo	valiendo
pastillas	astillas
rias	risa
conta	cinta
pf	pd
escorpio	escordio
escorpiana	escorpina
aqe	ate
ovarios	varios
cambiando	cambiado
estrellas	estrella
conchuda	conchudo
cristina	cristino
bye	bue
ajam	ajar
jaz	haz
pebette	pebete
three	toree
deeee	eeee
todooo	todoo
mojarme	mojarle
neee	eeee
perdi	pendi
talvez	calvez
hoiaaaa	holaaaa
noseee	nosee
casados	casaos
simpson	simplon
fisica	fisico
sacate	sacare
anmino	andino
maaan	masan
safas	sofas
tokar	tocar
viola	voila
nda	onda
milanesa	milanes
jaajaja	jajaja
sacate	sacare
preguntamos	preguntanos
blancoo	blanco
sacate	sacare
enkanta	encanta
als	ala
aunqe	aunque
duel	fuel
recomendas	recomendar
ningunoo	ninguno
tdavia	todavia
tengoo	tengo
demaciado	demasiado
tambiien	tambien
okeey	okey
laas	las
vooos	voos
toodo	todo
biiem	biien
buueno	bueno
jjsajaja	jjajaja
buueno	bueno
okeyy	okey
emmmmm	emmmm
beesitos	besitos
futbolistaa	futbolista
noose	nose
what	chat
fack	facu
hell	hele
serle	serre
hooooola	hoooola
fantasmas	fantasmal
axel	axe
pelotudos	pelotudo
maru	mare
areh	aren
ratos	rayos
pibas	pibes
violo	virolo
areh	aren
funciono	funcion
agustina	agustino
drogando	rogando
mamu	mami
papu	papua
ames	aes
mamu	mami
sarpen	sarten
caprichos	capricho
mios	miso
palida	palido
daless	dales
otross	otros
daless	dales
mostras	mostrad
anonim	anonima
daless	dales
reveles	reveler
anonim	anonima
aprende	prende
ordenadoor	ordenador
jajajjajajaj	jajajajajajaj
soliado	solidado
mr	me
graciaas	gracias
nba	naa
wilde	wide
sabeer	saber
hermanitoo	hermanito
bye	bue
nba	naa
boludos	boludo
juagr	jugar
enla	ella
pola	pila
suba	cuba
sales	dales
estudias	estudiar
penes	pense
enfermos	enfermoso
weee	wee
jodas	joda
okas	oka
tiraste	tirante
day	dar
maroon	maron
joe	jose
she	che
loved	moved
okas	oka
weee	wee
suscribo	suscrito
publican	publicar
mgg	mg
taoo	tao
okas	oka
look	cook
unidos	unidnos
olaaa	holaaa
jej	jet
grax	gray
xs	xd
preparo	reparo
agustina	agustino
beshitos	besitos
sabores	saboree
invisiblee	invisible
poqe	pope
sabria	saburia
mienten	vienten
husto	gusto
sabores	saboree
cumplimos	cumpliros
beshitos	besitos
poqe	pope
beshitos	besitos
obvioo	obvio
alexis	alexia
faltan	falton
personaalidad	personalidad
demaciado	demasiado
ahii	ahi
lastimarte	lastimarse
alexis	alexia
besiitos	besitos
nu	ni
mientas	mienta
jojo	aojo
bm	bum
mier	mire
lilaa	lila
favoritaa	favorita
capoo	capo
empeza	empoza
okii	oki
animas	animad
obligan	obligar
minutos	minuto
pelie	pele
sentarme	mentarme
caroo	caro
xqe	xq
acaba	sacaba
sentas	sentad
demaciado	demasiado
jajajajaaj	jajajajaja
temas	tomas
coraline	coralino
uñas	usas
cagen	calen
bloqueron	boqueron
nicole	nicol
lok	loa
titanic	titanio
puff	pufo
ritmica	ritmico
pzz	paz
tkm	km
muertos	muerto
siss	soss
cuanta	chanta
pregustas	preguntas
okei	okey
zapatillas	zapatilla
uff	uf
ren	ten
hodaa	holaa
lindu	hindu
io	yo
iara	rara
saver	saber
tucan	trucan
safa	saga
minas	minad
men	en
ajjajaja	jajajaja
its	is
tumblr	tumbar
malas	balas
mueroo	muero
gomas	tomas
movimientos	movimiento
of	ok
course	corse
xx	xq
siiiii	siiii
valerie	valerse
bass	basa
what	chat
makes	mares
born	boro
this	chis
way	gay
have	hace
for	foro
good	godo
okay	oka
for	foro
omg	mg
much	mucha
good	godo
night	light
babe	baba
my	mi
favorite	favorita
pink	pino
for	foro
xx	xq
okay	oka
for	foro
xx	xq
creas	cresa
modos	codos
mechi	mecho
hole	hile
holo	holi
equivocas	equivocar
deseas	desdas
pensalo	pensarlo
sele	cele
ana	and
seño	seno
patricia	patricio
ocupada	ocupad
laminas	laminad
estudia	estudio
laminas	laminad
valentina	valentona
elimino	elimine
perdono	persono
auf	puf
und	and
ein	din
kein	kien
fick	fice
nicht	nicho
selena	helena
sepas	seas
admiro	admito
hi	ji
selena	helena
not	note
believe	relieve
my	mi
that	chat
your	tour
talent	talento
boe	be
sacarias	sacaras
grr	gro
seep	see
thu	tau
compares	compare
compares	compare
stereo	etereo
aldo	alto
patineta	patinete
oct	oca
suizas	suiza
nda	onda
muii	mui
bonitho	bonito
qieres	quieres
cdt	cd
proo	pro
ermanos	hermanos
qesoo	besoo
creoo	creo
serah	seran
secretoo	secreto
dd	dad
thu	tau
contesto	contesta
cosoo	coso
aguss	aguas
vle	ble
metemos	mesemos
asique	psique
comprate	comparte
ocurra	curra
tarada	parada
pajera	pajero
critican	critica
paris	pares
provincias	provincial
favoritas	favorita
abel	rabel
acabo	acaro
sep	seo
puff	pufo
muchisimos	muchisimo
abel	rabel
pablo	pabulo
alboran	albaran
axel	axe
muchisimos	muchisimo
dejes	dijes
odien	odies
dadora	adora
entiendes	entiende
llegaron	legaron
cheta	chepa
conoceme	conocerme
veni	ven
cagada	canada
tenian	tendian
sacarme	secarme
caras	caray
salgan	valgan
significan	significar
salgas	salgase
cheta	chepa
cheta	chepa
cheta	chepa
paresca	parezca
ares	area
jajajaajaja	jajajajaja
ofendes	ofender
cheta	chepa
prepararme	prepararse
volando	colando
amaria	ataria
paris	pares
generos	generoso
juntare	juntate
cuakes	cuales
put	out
enferma	enferme
alone	alobe
pedimelo	pedidmelo
cositas	rositas
jajajjaa	jajajaja
jja	jaj
habi	jabi
necesitas	necesitar
contestare	contestar
jsj	jaj
chi	cho
xx	xq
ninfomana	ninfomania
llames	llame
matara	mutara
chupen	chufen
llebamos	llevamos
estooo	estozo
noseep	nosee
exageres	exagere
otrooo	otroo
muertos	muerto
sofia	cofia
anonimus	anonimos
sep	seo
erez	eres
tube	tuve
tube	tuve
lu	pu
graduados	graduador
escrbir	escribir
tomi	romi
fonse	fonje
alexis	alexia
valentin	valenton
faccu	facu
mires	mire
jua	gua
miles	diles
esteban	estaban
esteban	estaban
esteban	estaban
laaaa	aaaa
ba	va
tum	pum
pass	pasa
muscia	musca
sanjo	sanje
my	mi
zarcasmo	sarcasmo
pienos	pianos
pierde	pierre
oportuniudad	oportunidad
garcha	jarcha
peluda	pelusa
iso	izo
suscribo	suscrito
sms	sis
claa	clan
wii	ii
vallas	vallar
geronimo	jeronimo
nooooo	noooo
alpargatas	alpargata
avos	amos
capooo	capoto
bocaaa	bocana
jaaj	jaja
yooo	yoo
empedo	empedro
juana	juan
sisii	sisi
pardini	pardina
entras	entrar
reglas	reglad
chances	chance
dominra	dominar
quienn	quien
graciass	gracias
soyy	soy
chauu	chau
chauu	chau
graciass	gracias
partidos	partido
debio	debo
sisisi	sisis
gustooo	gustoso
mejorr	mejore
siiiii	siiii
weee	wee
candee	cande
juju	ijuju
llames	llame
clasicos	clasico
tambieen	tambien
hooolaa	hooola
caprichos	capricho
caramelos	caramelo
narnia	narina
mentiraa	mentira
paris	pares
male	dale
aldi	alli
entree	entre
gustaaa	gustaa
blanc	blanca
caprichos	capricho
mass	maas
labradora	labrador
brian	frian
seba	ceba
besooooo	besoooo
entretenerme	entretenerse
rolando	colando
aam	ama
vuelan	cuelan
tatoo	tato
brian	frian
valeee	daleee
romii	romi
ook	ok
okaa	oka
fabre	abre
sool	sol
zarate	carate
irii	iris
ballay	ballar
joor	loor
ayee	ayer
ailen	hilen
yooo	yoo
jajjaaja	jajajaja
ajam	ajar
sacaa	saca
queee	quee
ook	ok
ooka	oka
baasura	basura
ssii	sii
okok	okk
jooo	jobo
pau	tau
alp	ale
bobita	bonita
veses	veces
pensa	penca
okii	oki
okii	oki
okii	oki
sisisi	sisis
jajajajjajajaja	jajajajajajajaja
alguun	algun
dell	dela
xx	xq
primoo	primo
deel	del
yy	ya
culpaa	culpa
algu	algun
primoo	primo
alone	alobe
vz	vez
tanien	tapien
aoraa	aora
caas	casa
antess	antes
ibva	iba
cuentoo	cuento
algoo	algo
contarr	contar
vz	vez
contame	contadme
algoo	algo
jaajj	jajaj
portoo	porto
aoraa	aora
domingoo	domingo
voyy	voy
solteroo	soltero
peroo	pero
ideaa	idea
tengoo	tengo
boludoo	boludo
transar	tranzar
trancee	trance
qq	q
enseerio	enserio
metii	meti
vz	vez
vz	vez
peroo	pero
vidaa	vida
vien	bien
tambienn	tambien
yy	ya
mierdaa	mierda
hise	hice
romperr	romper
bolas	bolsa
mierdaa	mierda
ysee	see
fede	cede
wachi	wacha
eaea	enea
sims	sima
shico	chico
shico	chico
mientan	mienta
valorate	valorare
conectado	conectad
medirla	pedirla
grasias	gracias
asc	asa
io	yo
alesi	aleli
jajajajaajjaja	jajajajajajaja
nopp	nop
vayas	vayan
noop	nop
secret	secrete
peee	pee
osito	obito
osito	obito
sordito	sordido
chistes	chiste
pelotudos	pelotudo
ponemos	poneos
jajajaajajajaja	jajajajajajaja
jajajajaa	jajajaja
elian	lian
fanatica	fanatice
mamu	mami
compro	compra
pablo	pabulo
jajajajajaa	jajajajaja
faby	faba
twitteo	twitter
deban	daban
faby	faba
practicas	practicar
tuyas	tuya
bardee	barde
bardear	bardar
faby	faba
fodda	fonda
diaz	dias
reeee	eeee
moira	boira
alabarte	alabarse
sebastian	sebastiano
laura	launa
maar	mar
alpedo	alcedo
net	nen
full	fuel
jua	gua
jua	gua
cam	caz
desconfia	desconfiar
platonicos	platonico
mmmmm	mmmm
regaeton	regaton
rubias	rubios
ajajaa	ajaja
bebiba	bebida
bardeo	bordeo
cristian	cristiane
sabados	sabado
domingos	domingo
pensa	penca
daleees	daleee
etso	eso
biem	bien
bob	bobo
damas	demas
regge	regle
